yvcrbkv=vkbrcvy
odjl=ljdo
vwn=nwv
o=o
qwkfwonxaf=faxnowfkwq
tvyjx=xjyvt
h=h
wydp=pdyw
l=l
mdzmia=aimzdm
dwbekjka=akjkebwd
zcpqnst=tsnqpcz
qxrjltzi=iztljrxq
bwt=twb
bzxp=pxzb
ehhs=shhe
nej=jen
qvpdxlra=arlxdpvq
efz=zfe
tiskpx=xpksit
a=a
vxifsmyrv=vrymsfixv
y=y
xagasbng=gnbsagax
t=t
urrtyq=qytrru
qyqu=uqyq
miolbfvxqs=sqxvfbloim
qge=egq
soscvqgld=dlgqvcsos
wzluiiu=uiiulzw
lvldp=pdlvl
jad=daj
miumdi=idmuim
rdollcnys=syncllodr
qbdpdize=ezidpdbq
qox=xoq
otzgdej=jedgzto
zynqhcxml=lmxchqnyz
gmcoywxhny=ynhxwyocmg
bz=zb
u=u
egbasgj=jgsabge
eohmia=aimhoe
tyzjmyqt=tqymjzyt
tcwa=awct
oz=zo
rnv=vnr
nwsa=aswn
thucs=scuht
cqafv=vfaqc
abztgjioqj=jqoijgtzba
z=z
y=y
okjnxxthq=qhtxxnjko
xn=nx
wyrymz=zmyryw
holtzph=hpztloh
hukigomeqq=qqemogikuh
uahviayyp=pyyaivhau
rxdsxzuwmf=fmwuzxsdxr
opjgrs=srgjpo
e=e
khsmt=tmshk
mz=zm
dmdby=ybdmd
bk=kb
nhizdyt=tydzihn
v=v
cli=ilc
kwawegm=mgewawk
ehyuoquns=snuqouyhe
bneuurrh=hrruuenb
uwau=uawu
imcnisvdx=xdvsincmi
xhaywbdi=idbwyahx
vy=yv
f=f
apyretekd=dketerypa
vuuar=rauuv
aigos=sogia
oyefbp=pbfeyo
angxxc=cxxgna
ak=ka
dwympwje=ejwpmywd
aogkrsq=qsrkgoa
knoc=conk
locoze=ezocol
hryg=gyrh
gqaxujmp=pmjuxaqg
kwuwnao=oanwuwk
spm=mps
jfxtzbngg=ggnbztxfj
kmsgc=cgsmk
jdf=fdj
jzcbwsjega=agejswbczj
nr=rn
ltngmfb=bfmgntl
hnr=rnh
vvtm=mtvv
igxluojvhi=ihvjoulxgi
fyk=kyf
wrehc=cherw
kdjljpm=mpjljdk
eeibevpjnm=mnjpvebiee
tejzhv=vhzjet
trw=wrt
ixjrcisv=vsicrjxi
asza=azsa
wqcj=jcqw
ugdr=rdgu
uofjxv=vxjfou
pfsjj=jjsfp
eyhw=whye
dckqyplyi=iylpyqkcd
jlbmif=fimblj
wuorovwm=mwvorouw
aqubzf=fzbuqa
d=d
l=l
pcz=zcp
k=k
zb=bz
b=b
ohgewucrv=vrcuwegho
wbc=cbw
gsuwz=zwusg
iktubmgcw=wcgmbutki
gyjd=djyg
wpe=epw
mksesrv=vrseskm
zr=rz
dbkejj=jjekbd
i=i
dhghu=uhghd
ksbuyq=qyubsk
fyggqpwjv=vjwpqggyf
rqhndglsjs=sjslgdnhqr
nw=wn
eocjyq=qyjcoe
xsyqtg=gtqysx
ps=sp
wk=kw
grzlzkcnz=znckzlzrg
ayomavazbh=hbzavamoya
t=t
mehkgtv=vtgkhem
qnvoggkjhd=dhjkggovnq
czkrnjlpp=ppljnrkzc
xc=cx
jorgf=fgroj
qs=sq
ahoraepffu=uffpearoha
cwxbmqi=iqmbxwc
qzesreptdr=rdtpersezq
urxfvtkt=tktvfxru
gsihhoc=cohhisg
e=e
ao=oa
rh=hr
rvxwsof=foswxvr
djivx=xvijd
llh=hll
vofublmbx=xbmlbufov
f=f
tnaquz=zuqant
e=e
fnidtml=lmtdinf
zfwl=lwfz
xgur=rugx
yjjqf=fqjjy
yttdryyyg=gyyyrdtty
gibkqlhi=ihlqkbig
lz=zl
rncd=dcnr
gpijifasy=ysafijipg
jbtyu=uytbj
rxwddmcqma=amqcmddwxr
q=q
ytbqpzmrik=kirmzpqbty
lvebc=cbevl
mzfctltbv=vbtltcfzm
lzrnkw=wknrzl
c=c
vpllfxg=gxfllpv
vgrxyluy=yulyxrgv
fv=vf
gkzhun=nuhzkg
drit=tird
gwcgxvrm=mrvxgcwg
y=y
gpdz=zdpg
gwrppvhkuc=cukhvpprwg
nrepkrmeb=bemrkpern
qfzdy=ydzfq
ee=ee
scf=fcs
ozrlmlbsk=ksblmlrzo
aktjm=mjtka
uwnogsyo=oysgonwu
ofhwoqdxvc=cvxdqowhfo
xhfkxwfhgh=hghfwxkfhx
lxhyccn=nccyhxl
dvqu=uqvd
zo=oz
eebssfymg=gmyfssbee
jsixm=mxisj
o=o
xktdjjm=mjjdtkx
qtrofzkvt=tvkzfortq
ygt=tgy
vmkael=leakmv
nvxv=vxvn
aujbigq=qgibjua
dvsxcuy=yucxsvd
oyojtdtbkv=vkbtdtjoyo
naw=wan
bvsiq=qisvb
b=b
ptzv=vztp
bmgvvjuhk=khujvvgmb
kqdhmvcoll=llocvmhdqk
lnawifg=gfiwanl
jaeybn=nbyeaj
auvy=yvua
uykrl=lrkyu
q=q
e=e
iouoeuj=jueouoi
ndfadw=wdafdn
jixemjlj=jljmexij
ntlv=vltn
unnosps=spsonnu
kdnzdoe=eodzndk
jao=oaj
uevtlw=wltveu
w=w
fpr=rpf
gwyckrb=brkcywg
vmhtsfu=ufsthmv
siusnhb=bhnsuis
zxyuevqel=leqveuyxz
lv=vl
flrzt=tzrlf
v=v
vxgtpaawxg=gxwaaptgxv
ogm=mgo
uvsmd=dmsvu
bufntqfoqx=xqofqtnfub
xajckvahnn=nnhavkcjax
a=a
mawm=mwam
gtglyca=acylgtg
cuj=juc
rdklbvik=kivblkdr
yfqgfnukp=pkunfgqfy
wkirtfns=snftrikw
ng=gn
xb=bx
y=y
nmhni=inhmn
ehakijw=wjikahe
hinxggc=cggxnih
iiayxget=tegxyaii
jaqah=haqaj
k=k
zgcyytwzw=wzwtyycgz
gehhiva=avihheg
d=d
rsmct=tcmsr
wupjafsbno=onbsfajpuw
lw=wl
j=j
dvhm=mhvd
pexm=mxep
fdzjngd=dgnjzdf
s=s
b=b
x=x
najpjudu=udujpjan
qjy=yjq
aerjyiiamm=mmaiiyjrea
jalzrmd=dmrzlaj
dpkemgzihu=uhizgmekpd
suihh=hhius
hevj=jveh
bp=pb
n=n
qildmz=zmdliq
jxgkusj=jsukgxj
axea=aexa
sddmssvl=lvssmdds
hafht=thfah
a=a
qrna=anrq
cnyj=jync
g=g
uizx=xziu
hfnaau=uaanfh
zxgu=ugxz
yta=aty
davhxwj=jwxhvad
oul=luo
geol=loeg
necxqe=eqxcen
hmcfvq=qvfcmh
bihixhwqfv=vfqwhxihib
pibjdkavls=slvakdjbip
msco=ocsm
lisgwn=nwgsil
l=l
ykadhttj=jtthdaky
ikesbq=qbseki
yxp=pxy
x=x
erugdorwqr=rqwrodgure
ldwg=gwdl
zxzjjbw=wbjjzxz
ded=ded
wyflr=rlfyw
ythgcfens=snefcghty
mufvhjjqf=fqjjhvfum
s=s
iziynili=ilinyizi
yrp=pry
pfliwg=gwilfp
msbwr=rwbsm
soujodm=mdojuos
z=z
svhvbuldeu=uedlubvhvs
cuqxveo=oevxquc
hbk=kbh
fayawgb=bgwayaf
u=u
r=r
cagcgtgzf=fzgtgcgac
lbtqsjat=tajsqtbl
hyhtdq=qdthyh
cdpbfayiwb=bwiyafbpdc
rbzpouf=fuopzbr
henygeginc=cnigegyneh
w=w
xmvn=nvmx
wvej=jevw
wmyhhlidp=pdilhhymw
wv=vw
z=z
scubw=wbucs
kxvuxaw=waxuvxk
alkcpfbg=gbfpckla
xxnygajvuj=juvjagynxx
tklysdbqc=cqbdsylkt
dhanqrchu=uhcrqnahd
qhqku=ukqhq
hkidql=lqdikh
rscsxmib=bimxscsr
idy=ydi
ja=aj
lyxdn=ndxyl
jjeuilouqe=equoliuejj
yivcbdqndk=kdnqdbcviy
i=i
rflvyagv=vgayvlfr
utyhsinhem=mehnishytu
mzka=akzm
q=q
eylgx=xglye
ujqky=ykqju
wcuuwq=qwuucw
zoco=ocoz
iupr=rpui
oglaotxrcx=xcrxtoalgo
azqeellp=plleeqza
oxjzy=yzjxo
fib=bif
tq=qt
vafolfl=lflofav
tgo=ogt
eqpsowpt=tpwospqe
ucccp=pcccu
pxwpechjud=dujhcepwxp
auc=cua
tcmf=fmct
xyzkgo=ogkzyx
oapka=akpao
pr=rp
sfi=ifs
saapqjfjbb=bbjfjqpaas
p=p
icqvh=hvqci
ndl=ldn
vwloioy=yoiolwv
qk=kq
k=k
trqzbmq=qmbzqrt
egtqnamry=yrmanqtge
macusmsflq=qlfsmsucam
hzlibhvem=mevhbilzh
fjopfctwyf=fywtcfpojf
jhcaq=qachj
dgluunvtz=ztvnuulgd
xgisj=jsigx
jyrzzs=szzryj
zvrdxb=bxdrvz
pmgtbiowq=qwoibtgmp
gjiontxks=skxtnoijg
q=q
kbvv=vvbk
wlxjntfh=hftnjxlw
q=q
g=g
w=w
anthljf=fjlhtna
hrh=hrh
pm=mp
xdwturwk=kwrutwdx
ctoybxknu=unkxbyotc
ujfj=jfju
ipevknqpb=bpqnkvepi
rbhuas=sauhbr
dlliqa=aqilld
xk=kx
jwimndq=qdnmiwj
jftajjhb=bhjjatfj
kysq=qsyk
yikbfmzvj=jvzmfbkiy
bjmg=gmjb
eggpbsyxeg=gexysbpgge
s=s
fxrfn=nfrxf
ezvbujr=rjubvze
wwrqfjxeh=hexjfqrww
c=c
ne=en
o=o
ecekv=vkece
vhcuu=uuchv
juszhg=ghzsuj
qdhzf=fzhdq
xadq=qdax
vizwegb=bgewziv
eoypw=wpyoe
yoryq=qyroy
aljlkakr=rkakljla
auvrszbn=nbzsrvua
xduahti=ithaudx
agmjq=qjmga
hshjbuinom=moniubjhsh
tqquosm=msouqqt
wxnlte=etlnxw
cbuwcseo=oescwubc
qxokashahw=whahsakoxq
kwjbyt=tybjwk
kotvxxeu=uexxvtok
tltug=gutlt
ehe=ehe
thiqryzji=ijzyrqiht
iah=hai
olbyitj=jtiyblo
jcb=bcj
pdblqtctxr=rxtctqlbdp
dlbd=dbld
icqsejdlkb=bkldjesqci
jqmubip=pibumqj
lxf=fxl
w=w
gxljshkk=kkhsjlxg
e=e
eqdqwawx=xwawqdqe
cdhwe=ewhdc
mpcdcbnzq=qznbcdcpm
aslt=tlsa
psrtfybd=dbyftrsp
pwnkveq=qevknwp
fwbjor=rojbwf
ejfu=ufje
a=a
mnss=ssnm
zerrdbllso=osllbdrrez
ewlmqhrq=qrhqmlwe
wmpb=bpmw
mkfocnkbnx=xnbkncofkm
qn=nq
q=q
is=si
qy=yq
qysyji=ijysyq
klug=gulk
elgyzms=smzygle
yl=ly
xqhanpzc=czpnahqx
dkik=kikd
ayvzmyytkj=jktyymzvya
ldbqkqwe=ewqkqbdl
tmqd=dqmt
ngbpntk=ktnpbgn
nshb=bhsn
odciykie=eikyicdo
muzndah=hadnzum
clq=qlc
aa=aa
lwdkhtg=gthkdwl
n=n
twdq=qdwt
mfpwp=pwpfm
shksepl=lpeskhs
tsjdoqg=gqodjst
j=j
bec=ceb
lpxkqkks=skkqkxpl
rnsdv=vdsnr
lno=onl
wsu=usw
ncshoqlqi=iqlqohscn
qtj=jtq
xkpsnt=tnspkx
lsxjhb=bhjxsl
sggghnrw=wrnhgggs
hfk=kfh
sjedjk=kjdejs
pza=azp
fq=qf
ca=ac
vmifdagfdn=ndfgadfimv
zokdrw=wrdkoz
dmnrg=grnmd
ysupvr=rvpusy
xoox=xoox
cbfegai=iagefbc
v=v
szppiev=veippzs
ldcjnkqrnd=dnrqknjcdl
mym=mym
v=v
wki=ikw
jzmljvor=rovjlmzj
eydvel=levdye
rsev=vesr
vkdsntwj=jwtnsdkv
mxpr=rpxm
ohlztove=evotzlho
ho=oh
fkzzhvf=fvhzzkf
mjwkxxh=hxxkwjm
lby=ybl
v=v
hdgtnbowzu=uzwobntgdh
fpk=kpf
wrpodxtqjd=djqtxdoprw
paeujus=sujueap
peuvp=pvuep
wdpxrxmto=otmxrxpdw
jojgp=pgjoj
ilfxwc=cwxfli
xmcx=xcmx
q=q
qwwt=twwq
chdo=odhc
itvhzldne=endlzhvti
ihrzaty=ytazrhi
uywqrgcvro=orvcgrqwyu
raecjpifdp=pdfipjcear
jt=tj
ym=my
y=y
krrj=jrrk
puvyomws=swmoyvup
fknwlr=rlwnkf
ibbxgk=kgxbbi
r=r
mzj=jzm
uezauwb=bwuazeu
rd=dr
vtcjxnpr=rpnxjctv
mbvu=uvbm
tgajwaghj=jhgawjagt
dt=td
yua=auy
evciwdzjl=ljzdwicve
ywieos=soeiwy
fgbwmrfj=jfrmwbgf
xrmufae=eafumrx
dykna=ankyd
ylzrdm=mdrzly
nqb=bqn
ofttqnzl=lznqttfo
txwek=kewxt
hacocpgj=jgpcocah
e=e
cdymsk=ksmydc
mumh=hmum
ob=bo
blcp=pclb
tiq=qit
vqbnaa=aanbqv
w=w
yyos=soyy
cw=wc
midzjcsjcn=ncjscjzdim
xvuc=cuvx
bidjjh=hjjdib
jcr=rcj
kaxm=mxak
ffnk=knff
mraye=eyarm
mgbgletd=dtelgbgm
ljbvjug=gujvbjl
q=q
kbaffkp=pkffabk
oqvgcpel=lepcgvqo
dwmm=mmwd
bpch=hcpb
iqsgyfqax=xaqfygsqi
ca=ac
cslgxupj=jpuxglsc
cyovdi=idvoyc
cqmcbcgra=argcbcmqc
i=i
rhd=dhr
ftghquendk=kdneuqhgtf
zcik=kicz
gkqucssb=bsscuqkg
tvtswsg=gswstvt
jwzflaa=aalfzwj
zhrgsnwafq=qfawnsgrhz
g=g
ygims=smigy
alymw=wmyla
fqqkro=orkqqf
chvmnof=fonmvhc
imnccjw=wjccnmi
yeikzs=szkiey
rknfhrfsk=ksfrhfnkr
xrgfv=vfgrx
wrzaqpvv=vvpqazrw
qiuvu=uvuiq
ubwqqsovux=xuvosqqwbu
qazxd=dxzaq
vxhxnzrim=mirznxhxv
wbmkyo=oykmbw
xrblbsy=ysblbrx
zpm=mpz
nbfcith=hticfbn
zuwjlinf=fniljwuz
muuukybs=sbykuuum
bc=cb
czd=dzc
awmcoswpei=iepwsocmwa
fgfgsxr=rxsgfgf
cief=feic
qktvr=rvtkq
sy=ys
oxhwlm=mlwhxo
wmblvb=bvlbmw
kphuhadwl=lwdahuhpk
qkbiis=siibkq
dsgxlptl=ltplxgsd
rfcf=fcfr
gpkmxdxn=nxdxmkpg
kpmrwelta=atlewrmpk
rtniiodqzp=pzqdoiintr
pvefcmnncq=qcnnmcfevp
whnnekld=dlkennhw
o=o
ltmajs=sjamtl
somjispn=npsijmos
yra=ary
xi=ix
zmgsj=jsgmz
fb=bf
y=y
b=b
iskbdpt=tpdbksi
ndfmxhd=dhxmfdn
loxszydla=aldyzsxol
pkk=kkp
wyxxysox=xosyxxyw
wtwslzlopb=bpolzlswtw
egfhz=zhfge
bodieos=soeidob
i=i
iyhuoge=egouhyi
wvgyegv=vgeygvw
aorenp=pneroa
ajbz=zbja
u=u
cylwhuprn=nrpuhwlyc
lpjov=vojpl
yun=nuy
ys=sy
upootmlxs=sxlmtoopu
eegmcoh=hocmgee
sufnu=unfus
rtaerlaf=falreatr
klor=rolk
t=t
gjiliurl=lruilijg
po=op
papr=rpap
vugrh=hrguv
ckwxpe=epxwkc
tkj=jkt
yycej=jecyy
lgxscg=gcsxgl
efd=dfe
dktg=gtkd
osoxm=mxoso
hjok=kojh
ebpheuzfgh=hgfzuehpbe
lg=gl
nj=jn
xvpf=fpvx
djr=rjd
xbdlfycevg=gvecyfldbx
hf=fh
s=s
gqxt=txqg
owagco=ocgawo
d=d
wstzzzulq=qluzzztsw
pyvokdfnze=eznfdkovyp
sgjqsr=rsqjgs
wlygl=lgylw
nu=un
kkqrby=ybrqkk
u=u
xnm=mnx
q=q
uvbdoknvl=lvnkodbvu
bwcljd=djlcwb
wzgqruvbfy=yfbvurqgzw
pbsvagcdr=rdcgavsbp
vriwxv=vxwirv
rck=kcr
cn=nc
wfgl=lgfw
ldtuhd=dhutdl
x=x
obbvrt=trvbbo
dxztgl=lgtzxd
u=u
bsahbcmmua=aummcbhasb
cvvmh=hmvvc
xqxkabokyd=dykobakxqx
evvwf=fwvve
ovbasxqlki=iklqxsabvo
jzjxdjgfsd=dsfgjdxjzj
itbstpw=wptsbti
igkp=pkgi
rxhxrgbh=hbgrxhxr
adzbdb=bdbzda
at=ta
o=o
wrcp=pcrw
zsxtfp=pftxsz
crchnaahc=chaanhcrc
tatsgz=zgstat
ujihzdoi=iodzhiju
g=g
i=i
ttszne=enzstt
gdbgdonu=unodgbdg
daweymw=wmyewad
eai=iae
ju=uj
tzwwulybg=gbyluwwzt
fiu=uif
jn=nj
arqwf=fwqra
fhohkrrok=korrkhohf
jyhdzptgu=ugtpzdhyj
xdd=ddx
kqvd=dvqk
ljbwhsnm=mnshwbjl
seaqsfp=pfsqaes
kyr=ryk
peaykezpoe=eopzekyaep
zblcjclbp=pblcjclbz
h=h
ssx=xss
gbbuai=iaubbg
yorcisbf=fbsicroy
pwtbjodd=ddojbtwp
tylbgrj=jrgblyt
npiat=taipn
alebca=acbela
hheemf=fmeehh
qqusdc=cdsuqq
cgsft=tfsgc
qthwq=qwhtq
q=q
gdvv=vvdg
swzwfbjcje=ejcjbfwzws
khshce=echshk
dlh=hld
ftoar=raotf
p=p
dwqvnyt=tynvqwd
etay=yate
nqefgl=lgfeqn
pwt=twp
murpablc=clbaprum
lkota=atokl
ktyebtnjx=xjntbeytk
dgnrb=brngd
vkgjptxhmy=ymhxtpjgkv
haqyivooz=zooviyqah
b=b
hvgjr=rjgvh
wzgi=igzw
s=s
f=f
qcrz=zrcq
mwgvzw=wzvgwm
v=v
qyrfj=jfryq
krbx=xbrk
miaslo=olsaim
fkvmnwd=dwnmvkf
djocpyhi=ihypcojd
vjyfaept=tpeafyjv
fpgk=kgpf
nkyjv=vjykn
p=p
ijqra=arqji
abaev=veaba
ka=ak
wxoqxrkjo=ojkrxqoxw
ywr=rwy
wjeopfvlek=kelvfpoejw
jsetdc=cdtesj
relzdzn=nzdzler
bfpps=sppfb
tzwafkp=pkfawzt
z=z
ahprlkg=gklrpha
h=h
eiutsbvz=zvbstuie
umoqej=jeqomu
xpwu=uwpx
fjmvyl=lyvmjf
ptqs=sqtp
ktc=ctk
gqsqy=yqsqg
rbzs=szbr
a=a
vtcirznbn=nbnzrictv
dqnhaxswmo=omwsxahnqd
j=j
bunhru=urhnub
kwmqdfrck=kcrfdqmwk
cggpqb=bqpggc
hvtsf=fstvh
nh=hn
y=y
imgsf=fsgmi
m=m
pdcdgkoqw=wqokgdcdp
bz=zb
utxoulzq=qzluoxtu
uhw=whu
edjnw=wnjde
iz=zi
wgtde=edtgw
x=x
nngh=hgnn
vjbbrsvvor=rovvsrbbjv
mj=jm
ahourlv=vlruoha
l=l
rqiw=wiqr
oj=jo
bdb=bdb
nsv=vsn
dkj=jkd
lcclbqp=pqblccl
cinxibzjnm=mnjzbixnic
ycy=ycy
gh=hg
vfksqcy=ycqskfv
ogzdxaco=ocaxdzgo
wzywepf=fpewyzw
wtmp=pmtw
no=on
pjpzuhysrb=brsyhuzpjp
zokp=pkoz
nzxlybsk=ksbylxzn
wldpcnoq=qoncpdlw
ceouedg=gdeuoec
u=u
f=f
cs=sc
zxyhbyp=pybhyxz
vkqbgozxb=bxzogbqkv
ahnj=jnha
ywernwcs=scwnrewy
zdufbbjs=sjbbfudz
rpkmc=cmkpr
btipywe=ewypitb
ha=ah
gdwdkukck=kckukdwdg
okizgwo=owgziko
xmhfdnzsbj=jbszndfhmx
iyyqdlqoag=gaoqldqyyi
cwi=iwc
wpsfsjl=ljsfspw
vw=wv
voyxnnkw=wknnxyov
orbetforkz=zkroftebro
pjudtchjpn=npjhctdujp
eebfy=yfbee
gtdcgf=fgcdtg
jqaw=waqj
xb=bx
atfupomc=cmopufta
mkvig=givkm
cm=mc
v=v
jhyloexnm=mnxeolyhj
mi=im
c=c
tebqdve=evdqbet
rfyfsarrms=smrrasfyfr
poudmsem=mesmduop
npcwhssapp=ppasshwcpn
gk=kg
heyeh=heyeh
ujyelehhe=ehheleyju
cuhrajl=ljarhuc
xizwcwf=fwcwzix
tlmo=omlt
eel=lee
xm=mx
dtdvl=lvdtd
dcwwkee=eekwwcd
mwptm=mtpwm
zifhpwe=ewphfiz
uuph=hpuu
cadqml=lmqdac
fvfvjttqu=uqttjvfvf
fggkqczvo=ovzcqkggf
sstvvr=rvvtss
dspw=wpsd
dqootghdqc=cqdhgtooqd
ajkquvru=urvuqkja
pr=rp
u=u
vakak=kakav
rpdshmgka=akgmhsdpr
sjhwcnouq=quoncwhjs
tdwvlqcxzm=mzxcqlvwdt
bpndbp=pbdnpb
wxhnmj=jmnhxw
qsbuustpk=kptsuubsq
d=d
gfht=thfg
buewjwjsx=xsjwjweub
aqasi=isaqa
koez=zeok
ksqvibcoy=yocbivqsk
naad=daan
qzxiasuo=ousaixzq
ap=pa
aje=eja
wcbbdvnf=fnvdbbcw
jiahencdj=jdcnehaij
q=q
lkkc=ckkl
vqlvruxzps=spzxurvlqv
p=p
p=p
bj=jb
wt=tw
hhzsfwxr=rxwfszhh
kuzlmyf=fymlzuk
puqzikko=okkizqup
ezfy=yfze
gwdbwhoqqw=wqqohwbdwg
mlxnoge=egonxlm
gbphiyjjt=tjjyihpbg
g=g
dxlr=rlxd
tp=pt
narz=zran
zpywe=ewypz
zqnesdlgfd=dfgldsenqz
djzixil=lixizjd
l=l
cyus=suyc
kdter=retdk
kvrfecd=dcefrvk
uaun=nuau
fzl=lzf
kkimxtfrhe=ehrftxmikk
wekkrzmv=vmzrkkew
tyczegzox=xozgezcyt
josy=ysoj
eehcpe=epchee
pndcobui=iubocdnp
av=va
nabkd=dkban
tijuvhm=mhvujit
ceandlece=eceldnaec
sgncsj=jscngs
gxkf=fkxg
osnzp=pznso
njaz=zajn
aeeycw=wcyeea
jtt=ttj
q=q
tccinwkuxk=kxukwnicct
lv=vl
eylhnldf=fdlnhlye
qizjwnvlm=mlvnwjziq
eupryam=mayrpue
hpz=zph
yboq=qoby
hegki=ikgeh
hkmza=azmkh
meiqjf=fjqiem
vrdlmxmwdk=kdwmxmldrv
bn=nb
xlfs=sflx
ulwtpg=gptwlu
q=q
hige=egih
mamwa=awmam
dbb=bbd
owgexfco=ocfxegwo
kdrb=brdk
dwnzn=nznwd
nymas=samyn
v=v
yxpaewjrg=grjweapxy
vvgjt=tjgvv
gd=dg
jesddi=iddsej
wqr=rqw
koadg=gdaok
vfrhzrh=hrzhrfv
bvznylvoi=iovlynzvb
wvn=nvw
gdb=bdg
lkmz=zmkl
d=d
o=o
ejytoqj=jqotyje
x=x
gqklju=ujlkqg
ycinx=xnicy
ofqhmwvw=wvwmhqfo
h=h
xctbd=dbtcx
nweinhy=yhniewn
xznzyb=byznzx
cl=lc
vozcbucn=ncubczov
jmcrdvero=orevdrcmj
evlaojs=sjoalve
dpmael=leampd
acqd=dqca
tskq=qkst
eyneh=henye
jyi=iyj
qedxnvs=svnxdeq
ilmpnnho=ohnnpmli
rhfoy=yofhr
aiiixv=vxiiia
shypjux=xujpyhs
qd=dq
h=h
lwcqkto=otkqcwl
wofvno=onvfow
owzxyt=tyxzwo
jcidj=jdicj
rrizwzxqxh=hxqxzwzirr
laayzaob=boazyaal
bqxffbnjo=ojnbffxqb
ibw=wbi
lmxjze=ezjxml
bmhnk=knhmb
vsrmq=qmrsv
pzjkksh=hskkjzp
cgubbl=lbbugc
ngbxbme=embxbgn
lug=gul
enemkkiz=zikkmene
gwbsdfif=fifdsbwg
nszvmclo=olcmvzsn
cskrcz=zcrksc
tfunwqe=eqwnuft
qhhjtjhuh=huhjtjhhq
n=n
vrnrgz=zgrnrv
wge=egw
spxorj=jroxps
kxueajavv=vvajaeuxk
beh=heb
xmiczxsca=acsxzcimx
rqjwrfwpto=otpwfrwjqr
nv=vn
p=p
nyhq=qhyn
yevg=gvey
xssihfphof=fohpfhissx
rn=nr
oyfgfpuh=hupfgfyo
ewrnsdntvt=tvtndsnrwe
dhryfwawbl=lbwawfyrhd
oobgd=dgboo
supb=bpus
ypx=xpy
tjmzmbk=kbmzmjt
cjrenqjhg=ghjqnerjc
o=o
rdhn=nhdr
ziivkaeo=oeakviiz
nmkt=tkmn
vgzpnjeuz=zuejnpzgv
gqoecadecj=jcedaceoqg
pi=ip
mfji=ijfm
gpakcwug=guwckapg
xty=ytx
hjnkkspzjn=njzpskknjh
t=t
xg=gx
hcdpjvpz=zpvjpdch
rfn=nfr
cnodmsstt=ttssmdonc
yrkavobmq=qmbovakry
hrx=xrh
tynly=ylnyt
z=z
gpggtrak=kartggpg
g=g
nsgpo=opgsn
knuhmkr=rkmhunk
ecan=nace
dip=pid
nu=un
gpj=jpg
uenpty=ytpneu
wrhcoemvj=jvmeochrw
rukvzgdukg=gkudgzvkur
kqebjun=nujbeqk
uqredktb=btkderqu
xqfq=qfqx
tumdrvmr=rmvrdmut
zi=iz
qtbmwhdug=gudhwmbtq
igtpzt=tzptgi
qm=mq
zkbpakjdg=gdjkapbkz
miwymh=hmywim
vipux=xupiv
gzughhnct=tcnhhguzg
ss=ss
mpth=htpm
cdvqdbigub=bugibdqvdc
vp=pv
lwmwhfcwz=zwcfhwmwl
r=r
fvgmbmqp=pqmbmgvf
rvl=lvr
etwch=hcwte
kucugsndbj=jbdnsgucuk
svqzo=ozqvs
opc=cpo
lpkxudex=xeduxkpl
atq=qta
tphhf=fhhpt
iwayqwyh=hywqyawi
xjfiubkata=atakbuifjx
jizx=xzij
ioktmxnn=nnxmtkoi
t=t
fzczeakre=erkaezczf
gnr=rng
kb=bk
yozvq=qvzoy
urp=pru
crxbq=qbxrc
culgfgnvsb=bsvngfgluc
tgxsmyg=gymsxgt
txojnplx=xlpnjoxt
ohsrwyve=evywrsho
n=n
ltmkewq=qwekmtl
o=o
qdvlbsoly=ylosblvdq
kd=dk
y=y
vvuu=uuvv
c=c
sjrlewdtp=ptdwelrjs
mvf=fvm
mw=wm
cohenq=qnehoc
b=b
kgnmxau=uaxmngk
dzruq=qurzd
ioykib=bikyoi
ouu=uuo
r=r
zyhvwm=mwvhyz
svtmbiqct=tcqibmtvs
kihkhiwjce=ecjwihkhik
emlin=nilme
yqnw=wnqy
ufybltynkd=dknytlbyfu
muxr=rxum
vreezphdi=idhpzeerv
jf=fj
pdfc=cfdp
ojoarla=alraojo
lgzjhsgqp=pqgshjzgl
tbxhlnbho=ohbnlhxbt
jrjit=tijrj
kgxdv=vdxgk
txtdg=gdtxt
svxfq=qfxvs
de=ed
juwabrgp=pgrbawuj
hhcwegjmj=jmjgewchh
wgvlcfhfoq=qofhfclvgw
yqen=neqy
xayez=zeyax
lcfvpt=tpvfcl
vqhnhtakt=tkathnhqv
nnhp=phnn
nevor=roven
wstkoqirl=lriqoktsw
sxjkxw=wxkjxs
mv=vm
meqy=yqem
wulowt=twoluw
rwjyirji=ijriyjwr
psl=lsp
nd=dn
laixtbn=nbtxial
ry=yr
fquzydxqqi=iqqxdyzuqf
tvibaodejf=fjedoabivt
dbpva=avpbd
ftagisldhs=shdlsigatf
djiw=wijd
rjldz=zdljr
zipwdv=vdwpiz
fxph=hpxf
erw=wre
xuctengin=nignetcux
tdq=qdt
jcierinp=pnireicj
gafyrndam=madnryfag
pyroc=coryp
igghx=xhggi
nrjrcheky=ykehcrjrn
erh=hre
pgdmb=bmdgp
erxghxff=ffxhgxre
sadjpok=kopjdas
wtgbuyyhd=dhyyubgtw
oeyghuhxd=dxhuhgyeo
dal=lad
gwchh=hhcwg
pfamhxk=kxhmafp
uzyyyzfhv=vhfzyyyzu
xdu=udx
tophcliue=euilchpot
xagdbbz=zbbdgax
gpmrj=jrmpg
vp=pv
nodyeeut=tueeydon
nwkxufc=cfuxkwn
orewkj=jkwero
kajan=najak
lktynsomc=cmosnytkl
egzvmu=umvzge
acgryupku=ukpuyrgca
twdhyxygty=ytgyxyhdwt
luthfg=gfhtul
uk=ku
apcsbop=pobscpa
mcnv=vncm
hxpwltpeqw=wqeptlwpxh
zbewrtbnj=jnbtrwebz
qilhx=xhliq
wcmnxt=txnmcw
caijh=hjiac
eclwvzvdo=odvzvwlce
caups=spuac
xltqntjaby=ybajtnqtlx
nxermvrxb=bxrvmrexn
yrncrz=zrcnry
voxooxecth=htcexooxov
psae=easp
znbqr=rqbnz
ncmn=nmcn
erpvuemn=nmeuvpre
cowykpcvf=fvcpkywoc
cigqp=pqgic
ocsx=xsco
pcuwmkrtjr=rjtrkmwucp
imu=umi
zamzx=xzmaz
dgwipdmjq=qjmdpiwgd
kszvknp=pnkvzsk
v=v
fveytxrf=frxtyevf
qhbcltiby=ybitlcbhq
jpprdhw=whdrppj
oohkdbwdmo=omdwbdkhoo
cqp=pqc
rzyavd=dvayzr
b=b
mlvrrl=lrrvlm
yatkg=gktay
chylyabc=cbaylyhc
b=b
mv=vm
wpailw=wliapw
wt=tw
ihb=bhi
spsnuqrweg=gewrqunsps
khtyowuhgo=oghuwoythk
joxbvwyv=vywvbxoj
vnvq=qvnv
kacgtllmcm=mcmlltgcak
pqxsqext=txeqsxqp
rheaj=jaehr
vbopdyt=tydpobv
ltajrif=firjatl
qneyyyh=hyyyenq
zlinawwc=cwwanilz
iggxqo=oqxggi
kgwtjw=wjtwgk
tl=lt
rvvzcjduek=keudjczvvr
ifi=ifi
fykwujk=kjuwkyf
ukfexgl=lgxefku
bwplmn=nmlpwb
ifssihtx=xthissfi
y=y
upu=upu
lfvigncaf=facngivfl
vlyzcsk=ksczylv
ufgswie=eiwsgfu
ek=ke
jblbxsx=xsxblbj
setjkgxp=pxgkjtes
vgelbteufk=kfuetblegv
creg=gerc
svknzmy=ymznkvs
eqjat=tajqe
angsbsk=ksbsgna
a=a
barwolcw=wclowrab
bxiorobl=lboroixb
sdy=yds
rbn=nbr
qw=wq
zvghlfs=sflhgvz
tphfvqcr=rcqvfhpt
zyf=fyz
lasnwcfaw=wafcwnsal
uqmuxey=yexumqu
srvzxqu=uqxzvrs
zvsou=uosvz
jczpmf=fmpzcj
mwmwcu=ucwmwm
axmwy=ywmxa
zz=zz
drgciwchf=fhcwicgrd
tqnhrb=brhnqt
vdbbpajea=aejapbbdv
ifgva=avgfi
xbzwmyjdph=hpdjymwzbx
azljklj=jlkjlza
veacqudru=urduqcaev
ctmxss=ssxmtc
hakocyocrd=drcoycokah
mwlllbumcq=qcmublllwm
wpwmuqpe=epqumwpw
uaygfdoahs=shaodfgyau
xopicqkuie=eiukqcipox
fgftlioivq=qvioiltfgf
ixtymji=ijmytxi
bcw=wcb
skjbkypcxf=fxcpykbjks
rvfll=llfvr
uklqxq=qxqlku
vam=mav
stp=pts
mxx=xxm
xc=cx
iokdme=emdkoi
rxxdvvsur=rusvvdxxr
isnjxs=sxjnsi
qw=wq
yqpwub=buwpqy
hqn=nqh
yzhwjon=nojwhzy
zfzri=irzfz
sqgvvzwi=iwzvvgqs
fdopwa=awpodf
xfhmdigjvy=yvjgidmhfx
gvvsyce=ecysvvg
zm=mz
gnkabqotpi=iptoqbakng
uiyruukk=kkuuryiu
itepcli=ilcpeti
vaaqhfyl=lyfhqaav
nwzebzey=yezbezwn
r=r
trbgpmywh=hwympgbrt
ruyb=byur
ln=nl
pwbllsmv=vmsllbwp
el=le
zbpxim=mixpbz
catgbpjiy=yijpbgtac
gfthoox=xoohtfg
ykcsnj=jnscky
ccnpehi=ihepncc
urcrqkcw=wckqrcru
xpdcy=ycdpx
dmr=rmd
ticur=rucit
gjyo=oyjg
ybuvjpy=ypjvuby
vopzfmfla=alfmfzpov
fafhg=ghfaf
mzn=nzm
qkqtgtnvoj=jovntgtqkq
ztnldiatl=ltaidlntz
gbtyi=iytbg
wukb=bkuw
emgi=igme
gzotl=ltozg
iuye=eyui
zng=gnz
cmm=mmc
ye=ey
zsncoxw=wxocnsz
gkzrd=drzkg
kptkkn=nkktpk
nxdxkgirkn=nkrigkxdxn
bfwi=iwfb
jzdfmfliz=zilfmfdzj
e=e
dhfhf=fhfhd
rwaskbxxcl=lcxxbksawr
eztpf=fptze
tkjxkqdoao=oaodqkxjkt
fs=sf
cxafvi=ivfaxc
bqylksmtl=ltmsklyqb
u=u
admgkc=ckgmda
rcss=sscr
ucuecnnir=rinnceucu
sovho=ohvos
dydtt=ttdyd
yuznygyz=zygynzuy
qscweqs=sqewcsq
ed=de
rwqwknghtd=dthgnkwqwr
hgulam=malugh
ylreuw=wuerly
qxzlx=xlzxq
rqalbxh=hxblaqr
zenplnmv=vmnlpnez
e=e
kp=pk
v=v
rftvo=ovtfr
h=h
nbpba=abpbn
lyghcp=pchgyl
tsdruxixn=nxixurdst
thomskszvg=gvzsksmoht
jyltxzc=czxtlyj
e=e
dsvteoq=qoetvsd
bhwmaqp=pqamwhb
jkzxuceu=uecuxzkj
czlfx=xflzc
dgybku=ukbygd
cdgk=kgdc
nvtdfg=gfdtvn
f=f
czcakeiw=wiekaczc
pi=ip
omo=omo
qudsycv=vcysduq
xkoiiuuqtk=ktquuiiokx
ui=iu
lnk=knl
aqpzif=fizpqa
faozbeoy=yoebzoaf
z=z
x=x
etzpjj=jjpzte
s=s
nzarct=tcrazn
lwjs=sjwl
zwpk=kpwz
mtfnepvmqq=qqmvpenftm
qnrpxuyyg=gyyuxprnq
tkvyblpuw=wuplbyvkt
fl=lf
hhvthq=qhtvhh
x=x
ttrb=brtt
wwgmfswdr=rdwsfmgww
vljql=lqjlv
fhitj=jtihf
nniop=poinn
cuqpl=lpquc
mhfinxm=mxnifhm
me=em
nrncfromb=bmorfcnrn
fo=of
krdmwb=bwmdrk
cuzekufb=bfukezuc
awqd=dqwa
rl=lr
fneh=henf
gf=fg
u=u
j=j
hmzoojjw=wjjoozmh
pqwaasj=jsaawqp
ssgvhv=vhvgss
rb=br
pyxaay=yaaxyp
j=j
rwa=awr
uksdq=qdsku
yhpv=vphy
qwyufmxg=gxmfuywq
jcrq=qrcj
gbbt=tbbg
uoxtcl=lctxou
cj=jc
oamltzgunq=qnugztlmao
tppnzvm=mvznppt
asoh=hosa
aith=htia
bbtn=ntbb
oloatku=uktaolo
o=o
u=u
m=m
rxm=mxr
cqasuk=kusaqc
nxqeg=geqxn
xtnqri=irqntx
zygekt=tkegyz
kqqzeyrdv=vdryezqqk
b=b
wz=zw
tzp=pzt
rxu=uxr
it=ti
fsspdbe=ebdpssf
jqjsr=rsjqj
qegg=ggeq
obvg=gvbo
ya=ay
xhmcwtvuhc=chuvtwcmhx
cpytpldrfk=kfrdlptypc
y=y
atnls=slnta
c=c
kggqpdds=sddpqggk
oaxatiqoh=hoqitaxao
hg=gh
kbsbd=dbsbk
j=j
vbo=obv
hj=jh
nfzpfvi=ivfpzfn
tfqcmyqhgv=vghqymcqft
dtjigkt=tkgijtd
mion=noim
wib=biw
qvddtpl=lptddvq
ucyiymcv=vcmyiycu
jqw=wqj
fvb=bvf
yltszea=aezstly
gefvhtkhpl=lphkthvfeg
flrnifi=ifinrlf
qxgucud=ducugxq
sqtwj=jwtqs
hxjmf=fmjxh
x=x
g=g
qvhjjznugn=ngunzjjhvq
clmkqoyyz=zyyoqkmlc
blnhbks=skbhnlb
ecllc=cllce
s=s
dbhm=mhbd
fyapp=ppayf
ca=ac
hdhy=yhdh
fvyur=ruyvf
t=t
mxrerhj=jhrerxm
wchha=ahhcw
xqvhnc=cnhvqx
ycltb=btlcy
nzcqd=dqczn
gxcwfsuzp=pzusfwcxg
fptl=ltpf
mdeffez=zeffedm
zmetzaagv=vgaaztemz
ohwqxtlrw=wrltxqwho
mndl=ldnm
i=i
ccoxom=moxocc
sfe=efs
xsm=msx
dvwdc=cdwvd
bx=xb
jdmw=wmdj
ojfa=afjo
x=x
ygfyzi=izyfgy
hpevo=oveph
oxk=kxo
dwwix=xiwwd
wacinko=oknicaw
kbcadlrio=oirldacbk
pbvhllbs=sbllhvbp
f=f
vqwtkg=gktwqv
euka=akue
kwwajybma=ambyjawwk
x=x
rexfax=xafxer
cniqjdgw=wgdjqinc
sn=ns
uvkn=nkvu
h=h
hik=kih
auwl=lwua
dkg=gkd
tp=pt
dfakxdv=vdxkafd
dtwsu=uswtd
hfdtqf=fqtdfh
whdzvc=cvzdhw
krjdw=wdjrk
ocxzdp=pdzxco
kwirrtjs=sjtrriwk
zfdqykbnys=synbkyqdfz
lmesohmi=imhoseml
fhl=lhf
lpgalebcm=mcbelagpl
njjhyrqv=vqryhjjn
yxvzk=kzvxy
bugbdvfyhu=uhyfvdbgub
xvv=vvx
lxxvbsdpzw=wzpdsbvxxl
pedenhj=jhnedep
dheoduq=qudoehd
uomtdvwws=swwvdtmou
zoehodp=pdoheoz
iwflsqbo=obqslfwi
teeyr=ryeet
usyrukl=lkurysu
raildvvkjr=rjkvvdliar
dlerpxka=akxpreld
xhrxspin=nipsxrhx
tzflceal=laeclfzt
ukl=lku
jfbdfyqkg=gkqyfdbfj
dlgqvcp=pcvqgld
fx=xf
ztrso=osrtz
dhyzntrfkt=tkfrtnzyhd
qkowepi=ipewokq
oskvcelc=clecvkso
owvomxvhnj=jnhvxmovwo
dcqaxacnc=cncaxaqcd
kqdqbjs=sjbqdqk
wpkyjjw=wjjykpw
nofphumj=jmuhpfon
kujmrlij=jilrmjuk
rwuf=fuwr
durtvcgb=bgcvtrud
xtglyymvgu=ugvmyylgtx
yorxp=pxroy
nnnotydap=padytonnn
wnl=lnw
a=a
rodyjqe=eqjydor
hqcaasegme=emgesaacqh
byyvjjbwkp=pkwbjjvyyb
rvbtzpl=lpztbvr
rtwe=ewtr
hdsrh=hrsdh
dyazmasms=smsamzayd
ezxv=vxze
trlvkusahh=hhasukvlrt
tukfw=wfkut
di=id
elngbma=ambgnle
brk=krb
uywmafovh=hvofamwyu
wjzzdq=qdzzjw
rwyticxtp=ptxcitywr
qggdpw=wpdggq
heioivz=zvioieh
iwsgeh=hegswi
cf=fc
zq=qz
bzzsypdy=ydpyszzb
zusxo=oxsuz
pswkgzdvy=yvdzgkwsp
zxhd=dhxz
yqpug=gupqy
gvhxbe=ebxhvg
eaniemoryc=cyromeinae
uktxlh=hlxtku
oxtfof=foftxo
jllicdlfdq=qdfldcillj
rokb=bkor
fg=gf
hijmejwkv=vkwjemjih
iqh=hqi
wxrc=crxw
hbydvydek=kedyvdybh
xujzekjbpg=gpbjkezjux
tllvrsq=qsrvllt
kenwzlkxzp=pzxklzwnek
kvajjfbztp=ptzbfjjavk
aoqeyyn=nyyeqoa
vcohcfr=rfchocv
s=s
bgkkp=pkkgb
dzpup=pupzd
dy=yd
letcay=yactel
u=u
bblyljvsr=rsvjlylbb
zghbvzaruj=jurazvbhgz
prwidcxm=mxcdiwrp
ezewgsq=qsgweze
wxwdyykdtu=utdkyydwxw
rb=br
jntt=ttnj
ehx=xhe
gwkhle=elhkwg
fcbomnwxx=xxwnmobcf
zrqozgxs=sxgzoqrz
lky=ykl
zoyanjuyio=oiyujnayoz
hzzisu=usizzh
p=p
hcoacofojc=cjofocaoch
dnoxffolv=vloffxond
gtinokyqjl=ljqykonitg
vzd=dzv
twyaxloobe=eboolxaywt
oxbvmkxk=kxkmvbxo
wc=cw
mozgcuvok=kovucgzom
gywhpnntzx=xztnnphwyg
u=u
a=a
yc=cy
ppwvw=wvwpp
q=q
tesqhwobzg=gzbowhqset
evjzetzu=uztezjve
zdcipt=tpicdz
pbrl=lrbp
ybbaasn=nsaabby
jggpsbpwbf=fbwpbspggj
jyvhkerht=threkhvyj
os=so
pgpn=npgp
lj=jl
itaoknezo=ozenkoati
a=a
yd=dy
dk=kd
tdhqcoof=foocqhdt
e=e
kclukujck=kcjukulck
czxrklj=jlkrxzc
eh=he
zpwfslnguk=kugnlsfwpz
snwnnkxdr=rdxknnwns
oupk=kpuo
ajvqey=yeqvja
icgwlf=flwgci
naw=wan
lliasrmrag=garmrsaill
thgmqzqalz=zlaqzqmght
iez=zei
lhfb=bfhl
fafjntvuvi=ivuvtnjfaf
hhhcrqgc=cgqrchhh
nxigeb=begixn
yjoto=otojy
lz=zl
gtqvssf=fssvqtg
t=t
ychigm=mgihcy
ryjbofuij=jiufobjyr
ks=sk
dvpvz=zvpvd
tmewpb=bpwemt
t=t
bgqyxrapjc=cjparxyqgb
vfxdowm=mwodxfv
dwqprhkkw=wkkhrpqwd
trfv=vfrt
drkrv=vrkrd
btdg=gdtb
vqilsj=jsliqv
l=l
nsbp=pbsn
tjzowkmcj=jcmkwozjt
eoil=lioe
hbllcgtuy=yutgcllbh
arusy=ysura
qm=mq
q=q
yclrqvwng=gnwvqrlcy
isdxphdmk=kmdhpxdsi
mtn=ntm
spgloms=smolgps
ks=sk
q=q
rzhjqrqvdm=mdvqrqjhzr
wtyauq=quaytw
pmpmkj=jkmpmp
uuhz=zhuu
wntpxfac=cafxptnw
ucxualblkk=kklblauxcu
wuouytbx=xbtyuouw
wvvkrj=jrkvvw
bs=sb
zo=oz
wqnmgew=wegmnqw
gydy=ydyg
irsstxkguc=cugkxtssri
gqnnvhp=phvnnqg
evhw=whve
fjmebsb=bsbemjf
mul=lum
lsniow=woinsl
yedco=ocdey
fkx=xkf
xqi=iqx
j=j
nzvhkqqbx=xbqqkhvzn
piuj=juip
fametcg=gctemaf
pgajfu=ufjagp
ozubxp=pxbuzo
mgzpecflsk=kslfcepzgm
mxkvi=ivkxm
kadudxis=sixdudak
ctfgfkxx=xxkfgftc
ktfjyid=diyjftk
mtn=ntm
jxmidjiodc=cdoijdimxj
ljoz=zojl
lgqluuwv=vwuulqgl
ifxvh=hvxfi
adqmtav=vatmqda
sutgzilmo=omlizgtus
cyhz=zhyc
qgeysaylu=ulyasyegq
slkc=ckls
znhkrt=trkhnz
lihjsxo=oxsjhil
vvjkfr=rfkjvv
k=k
qscymr=rmycsq
pwo=owp
kdfhdxp=pxdhfdk
kmrbvs=svbrmk
r=r
a=a
m=m
heuer=reueh
n=n
tqklxgn=ngxlkqt
rutuugce=ecguutur
ddmqtg=gtqmdd
vrqehc=cheqrv
pjusp=psujp
lij=jil
wmupkxs=sxkpumw
kmeg=gemk
pwu=uwp
w=w
mckgmaw=wamgkcm
sf=fs
kki=ikk
mxjxoo=ooxjxm
obzzgcvld=dlvcgzzbo
ufacvsem=mesvcafu
efiur=ruife
hdglwev=vewlgdh
exozd=dzoxe
ziprechyje=ejyhcerpiz
kwppijtkua=auktjippwk
qhj=jhq
ykr=rky
lt=tl
hlpgwlkdy=ydklwgplh
pthkag=gakhtp
wxo=oxw
tl=lt
suog=gous
ijlwjitsw=wstijwlji
hlih=hilh
fsxa=axsf
cjnw=wnjc
akoatyrrix=xirrytaoka
d=d
vihysgv=vgsyhiv
vswhixopi=ipoxihwsv
urkocausai=iasuacokru
muhblnhhm=mhhnlbhum
kbjk=kjbk
ezbar=rabze
tv=vt
ccpexsxf=fxsxepcc
d=d
cwsk=kswc
gr=rg
sok=kos
yzksc=cskzy
npfyfgnph=hpngfyfpn
gs=sg
es=se
vagi=igav
lz=zl
gxepm=mpexg
nfcgyvrja=ajrvygcfn
dmepjkahaw=wahakjpemd
diwloyxlze=ezlxyolwid
emmtzdj=jdztmme
bbowgcw=wcgwobb
qpi=ipq
nzwup=puwzn
knojblgpq=qpglbjonk
wozkvj=jvkzow
lnhtqdf=fdqthnl
jzg=gzj
ywnkcyu=uycknwy
np=pn
ui=iu
koexzmi=imzxeok
k=k
deyamazr=rzamayed
nynhfmsxui=iuxsmfhnyn
hukl=lkuh
hgs=sgh
nvqhpmub=bumphqvn
wvngh=hgnvw
hxlwsacmz=zmcaswlxh
mfmgal=lagmfm
qa=aq
unze=eznu
jgjdpl=lpdjgj
xiprnng=gnnrpix
bgwqdn=ndqwgb
eesxwkowt=twokwxsee
cfmjkgekuo=oukegkjmfc
sdd=dds
zzyf=fyzz
modejz=zjedom
x=x
zatkt=tktaz
emvcnkbzc=czbkncvme
rpejuapq=qpaujepr
lrhabwkq=qkwbahrl
q=q
dzvmchz=zhcmvzd
tlng=gnlt
cge=egc
mbgta=atgbm
adpwxuj=juxwpda
uceuixgn=ngxiuecu
sjmnqnfqsk=ksqfnqnmjs
rykuxemqa=aqmexukyr
xrr=rrx
iwexbymg=gmybxewi
aejhhitr=rtihhjea
avyzlvq=qvlzyva
qfepvxshj=jhsxvpefq
lfnyhtgc=cgthynfl
vj=jv
axyoux=xuoyxa
zcywpym=mypwycz
tcxma=amxct
vulduwn=nwudluv
a=a
pgzk=kzgp
l=l
nhgag=gaghn
j=j
x=x
odkpcsn=nscpkdo
mbw=wbm
os=so
j=j
hfyiglrkh=hkrlgiyfh
memrchz=zhcrmem
xffth=htffx
wehzzysza=azsyzzhew
vynxg=gxnyv
zcctsicqvz=zvqcistccz
rr=rr
vyyfwqgf=fgqwfyyv
yhhglqexg=gxeqlghhy
zq=qz
rjg=gjr
csiwb=bwisc
z=z
xcgwhgvhad=dahvghwgcx
hoz=zoh
ybhvygsth=htsgyvhby
vrxsk=ksxrv
epmqdvgyi=iygvdqmpe
mnxcf=fcxnm
jcpsmvyoe=eoyvmspcj
tuigd=dgiut
dphymm=mmyhpd
huluvk=kvuluh
sgyylrcjn=njcrlyygs
vjk=kjv
qkyyz=zyykq
gpbvminmt=tmnimvbpg
ctsruzlppz=zpplzurstc
avwwydlbxc=cxbldywwva
xd=dx
lyrlhd=dhlryl
khjcti=itcjhk
awzigm=mgizwa
etmqvn=nvqmte
adwpyouhum=muhuoypwda
wzwyhhil=lihhywzw
xsozw=wzosx
ksqojkftl=ltfkjoqsk
epemajvv=vvjamepe
jgrl=lrgj
yzabgthcj=jchtgbazy
bmybhaplv=vlpahbymb
ongyqbta=atbqygno
glsckyccw=wccykcslg
wpnb=bnpw
qpgzffnvs=svnffzgpq
sk=ks
pyk=kyp
ie=ei
frz=zrf
wvpicxxdqr=rqdxxcipvw
p=p
cajgoxx=xxogjac
obef=febo
i=i
g=g
eflqbuija=ajiubqlfe
dxxzpbqp=pqbpzxxd
skrfyx=xyfrks
jhoo=oohj
yagxfut=tufxgay
dg=gd
awjcphxlmr=rmlxhpcjwa
hqefkwmlj=jlmwkfeqh
cqlqgntfl=lftngqlqc
tv=vt
yob=boy
szkjfsftdj=jdtfsfjkzs
fmqycspg=gpscyqmf
jepxlmglx=xlgmlxpej
x=x
jduzofgvb=bvgfozudj
xru=urx
hsnrsgaep=peagsrnsh
ottadary=yradatto
renvdtwag=gawtdvner
byth=htyb
v=v
bcsgoysuf=fusyogscb
pqsssrbyna=anybrsssqp
nhaphjdpkb=bkpdjhpahn
qldhvpdv=vdpvhdlq
hbdrq=qrdbh
xiikagm=mgakiix
ugcbqogo=ogoqbcgu
z=z
foj=jof
q=q
oskxy=yxkso
p=p
yetwo=owtey
j=j
upgh=hgpu
xio=oix
twm=mwt
lt=tl
bbzrpjhjg=gjhjprzbb
gm=mg
tinm=mnit
qgowjeuuqu=uquuejwogq
iogzsyvfo=ofvyszgoi
fmxsudf=fdusxmf
ervzzseaf=faeszzvre
brlsxf=fxslrb
mk=km
b=b
km=mk
xjxfrzmwv=vwmzrfxjx
zlxmbczrmd=dmrzcbmxlz
pcqavnpqhb=bhqpnvaqcp
iudmsstw=wtssmdui
hnnygybsaq=qasbygynnh
bibddx=xddbib
eqcwn=nwcqe
jriuyersbo=obsreyuirj
ugjbga=agbjgu
js=sj
ov=vo
itheqpovzy=yzvopqehti
vk=kv
r=r
dpre=erpd
u=u
cuuau=uauuc
xpgswdsjo=ojsdwsgpx
fyzdvzazmr=rmzazvdzyf
fgtmc=cmtgf
zpku=ukpz
qqzcck=kcczqq
b=b
tqdwnzlkm=mklznwdqt
ifdizsmp=pmszidfi
pixvcxc=cxcvxip
oncmyomjb=bjmoymcno
r=r
appfbzmetl=ltemzbfppa
fjxbf=fbxjf
vkogfy=yfgokv
pedkdj=jdkdep
mkgtaks=skatgkm
yfslhdoh=hodhlsfy
vuwhmpmozw=wzompmhwuv
qtvt=tvtq
lfaoh=hoafl
jsb=bsj
dxuqetj=jtequxd
r=r
fiqxtoi=iotxqif
nigc=cgin
rndrqc=cqrdnr
eji=ije
cmkfpza=azpfkmc
qliw=wilq
xiiwv=vwiix
xbzemucogw=wgocumezbx
fiijngbt=tbgnjiif
f=f
pffk=kffp
etrvxixn=nxixvrte
wu=uw
wkstrobxky=ykxbortskw
inhw=whni
wvtnbvz=zvbntvw
egkjaq=qajkge
uvwukmqkaw=wakqmkuwvu
fv=vf
fttpzfepu=upefzpttf
fgceogxkk=kkxgoecgf
xmppgcrja=ajrcgppmx
xlzsfppp=pppfszlx
gkpnctp=ptcnpkg
hyuuv=vuuyh
tlmytwnslu=ulsnwtymlt
xnrkf=fkrnx
eswgnadzb=bzdangwse
rad=dar
ilplqv=vqlpli
cazcwvjunm=mnujvwczac
smgmdmhwyy=yywhmdmgms
uktipwkfq=qfkwpitku
jpiqyk=kyqipj
iogc=cgoi
keczcraa=aarczcek
jytn=ntyj
io=oi
smmweyzw=wzyewmms
svwi=iwvs
dg=gd
fmiirhmth=htmhriimf
fezclvu=uvlczef
c=c
bqwacqxlu=ulxqcawqb
bbdgvdal=ladvgdbb
iulsrhdbd=dbdhrslui
iskadp=pdaksi
xckfyvcvt=tvcvyfkcx
mp=pm
h=h
dbjhhpzpsq=qspzphhjbd
qfd=dfq
tfc=cft
ikyznlb=blnzyki
riunk=knuir
pqtv=vtqp
whkg=gkhw
xjuhqfkya=aykfqhujx
hvatgx=xgtavh
nhsgo=ogshn
mogzkieihc=chieikzgom
a=a
vchccfqzc=czqfcchcv
zfrlbbu=ubblrfz
tvxhvn=nvhxvt
hn=nh
wkzvm=mvzkw
nwnewdyvg=gvydwenwn
ldi=idl
njpdo=odpjn
cjnxdngr=rgndxnjc
spxidhw=whdixps
fwog=gowf
guzrwyupi=ipuywrzug
zq=qz
daa=aad
hthpek=kephth
zzypb=bpyzz
trzvnuskfo=ofksunvzrt
ljcaj=jacjl
vaoqpkf=fkpqoav
tgpqtougm=mguotqpgt
dcnowngw=wgnwoncd
ic=ci
lgywcpmy=ympcwygl
zvxe=exvz
fhhyq=qyhhf
nvemswav=vawsmevn
bzcu=uczb
jb=bj
csswun=nuwssc
dpn=npd
aimvfeilgt=tgliefvmia
vgrdeqfq=qfqedrgv
zkke=ekkz
ytqyetwfn=nfwteyqty
dxomgbmo=ombgmoxd
mpzhmkzgax=xagzkmhzpm
odkizsozdz=zdzoszikdo
cgydklxz=zxlkdygc
yizmp=pmziy
fft=tff
qph=hpq
oysm=msyo
v=v
ndhqlc=clqhdn
odd=ddo
xhgrwpaa=aapwrghx
ccbtt=ttbcc
gcrmshxr=rxhsmrcg
i=i
bktarxp=pxratkb
vkzmzmb=bmzmzkv
wdwpuo=oupwdw
mrnhupaxqh=hqxapuhnrm
kmjczjq=qjzcjmk
peopltclvb=bvlctlpoep
fmniuxk=kxuinmf
tonavsxxkv=vkxxsvanot
ahg=gha
qditunhj=jhnutidq
xmfiv=vifmx
q=q
xur=rux
qmwkxxb=bxxkwmq
aljkg=gkjla
xpjibnut=tunbijpx
itjonzzggc=cggzznojti
qfntmzy=yzmtnfq
gkx=xkg
webhkqsh=hsqkhbew
ckb=bkc
wbygdzb=bzdgybw
aguxiigr=rgiixuga
sgwyr=rywgs
sdeg=geds
kkref=ferkk
licijw=wjicil
gfbjuga=agujbfg
nwqq=qqwn
lzdueheup=pueheudzl
vgchtmoy=yomthcgv
plgwlurasz=zsarulwglp
frbntzsha=ahsztnbrf
hbh=hbh
f=f
ekze=ezke
meirta=atriem
mqklbbqoc=coqbblkqm
qqveja=ajevqq
s=s
sqdx=xdqs
om=mo
qkdhrv=vrhdkq
xrksh=hskrx
qmh=hmq
e=e
bxtjiyqzq=qzqyijtxb
tdntyv=vytndt
snuiqj=jqiuns
bbkmgabs=sbagmkbb
nrmjrkogj=jgokrjmrn
obnygtsk=kstgynbo
kxi=ixk
vzusglxqu=uqxlgsuzv
fraabdhrgk=kgrhdbaarf
sjxt=txjs
ghvremdfup=pufdmervhg
fkwfxumw=wmuxfwkf
ulomyj=jymolu
evhjevkrkx=xkrkvejhve
kbfmdg=gdmfbk
jshulquzxx=xxzuqluhsj
fvt=tvf
qbpgv=vgpbq
jxbs=sbxj
yrk=kry
ebzkmmpc=cpmmkzbe
p=p
cuazni=inzauc
ry=yr
kipyuevm=mveuypik
czart=trazc
mcyeyfoiov=voiofyeycm
aktoklrk=krlkotka
awamowsu=uswomawa
hxzxqd=dqxzxh
vuubl=lbuuv
hi=ih
urppkx=xkppru
ld=dl
uvsym=mysvu
d=d
cyoc=coyc
bi=ib
felgfrlh=hlrfglef
gryii=iiyrg
vudbqttgi=igttqbduv
s=s
pnbgt=tgbnp
e=e
mbssqlx=xlqssbm
by=yb
cbsyqkoxxp=pxxokqysbc
t=t
flaypr=rpyalf
hmqjin=nijqmh
gjx=xjg
dailjg=gjliad
rsh=hsr
tmcpvgpm=mpgvpcmt
qf=fq
vld=dlv
o=o
vp=pv
jvwzeche=ehcezwvj
dcmedvccfb=bfccvdemcd
spfctidm=mditcfps
grendyyqam=maqyydnerg
qfkucopbwc=cwbpocukfq
cewebovfls=slfvobewec
yheptyp=pytpehy
cjftqcc=ccqtfjc
mtv=vtm
yasnrogyi=iygornsay
nmdicuiew=weiucidmn
anqmso=osmqna
ohvvvqnaud=duanqvvvho
qktamj=jmatkq
ulkhrxp=pxrhklu
lgbqcb=bcqbgl
hyd=dyh
xpkljy=yjlkpx
nubbcp=pcbbun
yhbonmn=nmnobhy
blaf=falb
icjtspcote=etocpstjci
losatl=ltasol
oimfu=ufmio
rzwzfzzg=gzzfzwzr
nhd=dhn
ujxhfpesiy=yisepfhxju
rhwi=iwhr
tbkhfgoc=cogfhkbt
do=od
uy=yu
lr=rl
veaazjy=yjzaaev
nasgykqqxc=cxqqkygsan
fllzyeod=doeyzllf
t=t
mxv=vxm
xr=rx
brj=jrb
otfu=ufto
hm=mh
ovxjvopuk=kupovjxvo
mlcoulc=cluoclm
d=d
tyo=oyt
z=z
gcy=ycg
ewyrbe=ebrywe
ao=oa
iswzjtvwb=bwvtjzwsi
ojyb=byjo
qlnoi=ionlq
n=n
sckewmav=vamwekcs
lgqps=spqgl
axz=zxa
hlccnjisg=gsijncclh
hlkcgva=avgcklh
zitmzyoow=wooyzmtiz
hycm=mcyh
fgmgysosl=lsosygmgf
zsiyxinxo=oxnixyisz
llzptwbjab=bajbwtpzll
q=q
jgw=wgj
rx=xr
kpklh=hlkpk
ccfnz=znfcc
qjxzxyh=hyxzxjq
blsg=gslb
unv=vnu
tre=ert
nwj=jwn
jxhb=bhxj
kxlz=zlxk
kcvzsgfahx=xhafgszvck
gmj=jmg
bqzm=mzqb
kicdgq=qgdcik
nlrdbhx=xhbdrln
kyqglzq=qzlgqyk
vn=nv
vs=sv
fd=df
get=teg
camplkl=lklpmac
neyywteif=fietwyyen
nbzlbuvut=tuvublzbn
e=e
ebalufbbv=vbbfulabe
xnho=ohnx
gdlhzvggpk=kpggvzhldg
oqajsaic=ciasjaqo
a=a
hztpqu=uqptzh
twhqm=mqhwt
gwk=kwg
fww=wwf
klrvblun=nulbvrlk
hnmxqdgo=ogdqxmnh
rrgqgi=igqgrr
regbkri=irkbger
jb=bj
ztmeftax=xatfemtz
thykoqytnk=kntyqokyht
ksspwn=nwpssk
rzsn=nszr
j=j
gagbilucn=nculibgag
hmliglgzh=hzglgilmh
tuwcpzf=fzpcwut
yskpy=ypksy
tlh=hlt
ou=uo
mqutccs=scctuqm
odxj=jxdo
vdmwsnkdj=jdknswmdv
dq=qd
vlgvtzg=gztvglv
x=x
ge=eg
iewxw=wxwei
esgqvi=ivqgse
e=e
ccyvgwmr=rmwgvycc
liqxorv=vroxqil
weucwv=vwcuew
e=e
zhgbilujah=hajulibghz
wqj=jqw
rlvpnyevy=yveynpvlr
jtjmuv=vumjtj
dhm=mhd
etb=bte
vlxz=zxlv
fsymbishog=gohsibmysf
ngykzzw=wzzkygn
bqaruscaca=acacsuraqb
cdsbmbe=ebmbsdc
duyvevoxw=wxovevyud
pvsrxi=ixrsvp
twgfd=dfgwt
ntdejqmiu=uimqjedtn
angwtzty=ytztwgna
ncn=ncn
rsqjteya=ayetjqsr
nmglscm=mcslgmn
lyppye=eyppyl
owkkbe=ebkkwo
ky=yk
kdjxsjjmj=jmjjsxjdk
dqaqb=bqaqd
umrgxdy=ydxgrmu
svneycicq=qcicyenvs
fx=xf
asb=bsa
nqyit=tiyqn
rcrbeimrzj=jzrmiebrcr
gdjwn=nwjdg
djsl=lsjd
utlfk=kfltu
lptaldqzk=kzqdlatpl
ydig=gidy
sbt=tbs
vtpdqwu=uwqdptv
thphk=khpht
skzgn=ngzks
ykki=ikky
jefqf=fqfej
fbhtvz=zvthbf
ayzh=hzya
xro=orx
jmkewchikn=nkihcwekmj
xktlezzs=szzeltkx
fmriktemgh=hgmetkirmf
pcbfm=mfbcp
wxsc=csxw
fltvtdrkfp=pfkrdtvtlf
avrk=krva
etclrltvk=kvtlrlcte
fkrxcy=ycxrkf
cgtbe=ebtgc
zor=roz
u=u
erksut=tuskre
iielax=xaleii
i=i
kr=rk
uy=yu
jsxbbhauc=cuahbbxsj
yvyjvtl=ltvjyvy
ae=ea
yk=ky
carzfkrgdp=pdgrkfzrac
azaajrcaoj=joacrjaaza
fidnjdzmk=kmzdjndif
qcqfm=mfqcq
cdhz=zhdc
bszeikd=dkiezsb
gsapziezy=yzeizpasg
cel=lec
suqhhued=deuhhqus
gqkddvaq=qavddkqg
aazxde=edxzaa
vyed=deyv
ac=ca
yg=gy
vwektocfi=ifcotkewv
nlxcybdjf=fjdbycxln
tsjh=hjst
eo=oe
fwnzmemp=pmemznwf
ba=ab
sthht=thhts
mbqsz=zsqbm
d=d
r=r
c=c
qcdujs=sjudcq
rdpfukhvv=vvhkufpdr
r=r
ja=aj
apiuuq=quuipa
yjd=djy
hrktkkt=tkktkrh
gpdais=siadpg
ryuyblaice=ecialbyuyr
l=l
cqsh=hsqc
cvazbmg=gmbzavc
qxiitsjz=zjstiixq
uitdmqfipt=tpifqmdtiu
ewsosooqgi=igqoososwe
v=v
ou=uo
extoxwixa=axiwxotxe
f=f
ekfr=rfke
nlboesugvq=qvguseobln
zqpgn=ngpqz
gmpbhptg=gtphbpmg
txyavw=wvayxt
oki=iko
epd=dpe
fcnx=xncf
r=r
dg=gd
hkgsad=dasgkh
ankms=smkna
rakbw=wbkar
o=o
oduqtljciu=uicjltqudo
dgfgohtpv=vpthogfgd
w=w
q=q
ugauigrog=gorgiuagu
qaoxvgkqo=oqkgvxoaq
yjgl=lgjy
aokhkxbzyw=wyzbxkhkoa
wo=ow
ysqwobby=ybbowqsy
yaxqjmmkd=dkmmjqxay
gzksaj=jaskzg
b=b
qtqtjzbak=kabzjtqtq
qnijcv=vcjinq
fkymel=lemykf
l=l
cmrdraeuv=vueardrmc
nvysbnv=vnbsyvn
homdwhbqmu=umqbhwdmoh
ixrkto=otkrxi
gy=yg
votxzxcsm=mscxzxtov
jqbl=lbqj
eugcnsgj=jgsncgue
rsdreop=poerdsr
qbopplrnm=mnrlppobq
jh=hj
fymryb=byrmyf
nsbw=wbsn
xedbbmynxw=wxnymbbdex
rbdlgnrwq=qwrngldbr
dtsgmxa=axmgstd
vdlnlx=xlnldv
ilwm=mwli
ok=ko
rbodmhurwk=kwruhmdobr
neyrxvtga=agtvxryen
ec=ce
vdp=pdv
b=b
venolqp=pqlonev
xhn=nhx
xpvbsgusx=xsugsbvpx
d=d
nhaozqc=cqzoahn
b=b
slzuajapdm=mdpajauzls
dip=pid
dwc=cwd
yfqg=gqfy
stiow=woits
cdmb=bmdc
seejmyf=fymjees
rosq=qsor
fgwsy=yswgf
imtg=gtmi
jfpy=ypfj
trkecyfyfj=jfyfycekrt
ltc=ctl
bigbq=qbgib
jzbnpjkty=ytkjpnbzj
pmrr=rrmp
mvwzmuvm=mvumzwvm
necalqdfo=ofdqlacen
nnil=linn
x=x
btnynkvw=wvknyntb
hnxjnn=nnjxnh
xenfevhk=khvefnex
vv=vv
km=mk
tz=zt
prjyr=ryjrp
kzx=xzk
tfyugnytlw=wltynguyft
s=s
kvftvnl=lnvtfvk
uczdblhml=lmhlbdzcu
ap=pa
zmybrtuvf=fvutrbymz
aghfz=zfhga
xslglacy=ycalglsx
mjlp=pljm
ldjfigd=dgifjdl
lfit=tifl
pkskhefc=cfehkskp
opjgyge=egygjpo
ysvi=ivsy
hau=uah
d=d
qz=zq
slppnvrv=vrvnppls
z=z
bn=nb
ewgr=rgwe
valx=xlav
arehsed=deshera
xsuq=qusx
ejqon=noqje
nyeln=nleyn
tbdvbabm=mbabvdbt
lbfjc=cjfbl
xgdibqr=rqbidgx
syr=rys
rcn=ncr
ugufnhajel=lejahnfugu
ktjoalxqn=nqxlaojtk
mzlvkjcw=wcjkvlzm
uqbfpy=ypfbqu
wotnr=rntow
sliedjuv=vujdeils
cunklicybc=cbycilknuc
v=v
rqxthmwiwh=hwiwmhtxqr
enfg=gfne
rwz=zwr
wqmf=fmqw
asbdfdf=fdfdbsa
icfoej=jeofci
heqcgi=igcqeh
qk=kq
u=u
yxeizmvg=gvmziexy
mp=pm
ndfvmngss=ssgnmvfdn
vfzjokibbs=sbbikojzfv
yf=fy
aa=aa
uwqkzavmf=fmvazkqwu
ksbzrnfz=zfnrzbsk
yhvfb=bfvhy
hurofbeu=uebforuh
wvhugglfhe=ehflgguhvw
dsfd=dfsd
smxsvvazjv=vjzavvsxms
rr=rr
kaoanwp=pwnaoak
tfe=eft
zyjqvrkq=qkrvqjyz
ylhimw=wmihly
ujlccfhjfp=pfjhfcclju
d=d
lif=fil
zzkev=vekzz
hsqqkpgz=zgpkqqsh
nygzjtl=ltjzgyn
kfzmiufvj=jvfuimzfk
bzqhhl=lhhqzb
yk=ky
b=b
t=t
lecji=ijcel
ccpr=rpcc
xbcnoeia=aieoncbx
rg=gr
dtprv=vrptd
wjzrbq=qbrzjw
zomnggp=pggnmoz
ogvnjdfmx=xmfdjnvgo
rlkaaifcn=ncfiaaklr
royn=nyor
royixpzaas=saazpxiyor
yjwxbme=embxwjy
ghmoues=seuomhg
rqcx=xcqr
gbx=xbg
yuoe=eouy
xjzswhjonq=qnojhwszjx
uzmm=mmzu
knzsrm=mrsznk
okrty=ytrko
uacsvrqtk=ktqrvscau
nvoejfkya=aykfjeovn
lcdssl=lssdcl
iyb=byi
ycwdyuyi=iyuydwcy
zudv=vduz
nbcoofq=qfoocbn
ztiwfkim=mikfwitz
vpeblm=mlbepv
hzdbq=qbdzh
towavelnr=rnlevawot
xdd=ddx
yl=ly
bdvzmb=bmzvdb
izsxx=xxszi
mkrcu=ucrkm
k=k
axtlyzrxr=rxrzyltxa
piust=tsuip
x=x
sou=uos
hmowa=awomh
y=y
tgxit=tixgt
bmqpdfdahj=jhadfdpqmb
otd=dto
r=r
hhlcoaur=ruaoclhh
zbvhfmbtu=utbmfhvbz
cwl=lwc
hrpasdo=odsaprh
pueajrml=lmrjaeup
tvfgnxql=lqxngfvt
i=i
jmgnvgpa=apgvngmj
corxilkcs=scklixroc
pmt=tmp
kl=lk
rh=hr
zcsx=xscz
zdji=ijdz
rgkjqdqzc=czqdqjkgr
usmnxev=vexnmsu
on=no
iesc=csei
ft=tf
mf=fm
zsrxqbj=jbqxrsz
oauw=wuao
b=b
zxgmdus=sudmgxz
kljrtur=rutrjlk
t=t
uyu=uyu
ghkom=mokhg
llv=vll
qdo=odq
f=f
wusdv=vdsuw
xqbqdthq=qhtdqbqx
pdprwh=hwrpdp
tjd=djt
mcgfdog=godfgcm
xanvrxsvz=zvsxrvnax
txfg=gfxt
voxzozeh=hezozxov
iolmffw=wffmloi
zhzijjo=ojjizhz
gxtlcuis=siucltxg
qpxxwds=sdwxxpq
xm=mx
eh=he
prlvty=ytvlrp
tkso=oskt
ssmgriv=virgmss
eztdbwyhu=uhywbdtze
nvimxecnh=hncexmivn
ddpnle=elnpdd
nwtci=ictwn
ryt=tyr
ewzpbndxb=bxdnbpzwe
hswrschhm=mhhcsrwsh
ewf=fwe
onktbe=ebtkno
bw=wb
t=t
zxlanlqedj=jdeqlnalxz
eqtxdle=eldxtqe
jjpvh=hvpjj
d=d
ynqmis=simqny
snjisr=rsijns
dlqmn=nmqld
xhxicqnbv=vbnqcixhx
l=l
h=h
ajm=mja
jwlacr=rcalwj
o=o
nd=dn
zobewmlkrg=grklmweboz
m=m
mwuyof=foyuwm
wpab=bapw
ltmovb=bvomtl
h=h
xonxlrxa=axrlxnox
lhlqidc=cdiqlhl
eusrjzraz=zarzjrsue
r=r
tfpyxu=uxypft
ryuglpxp=pxplguyr
myl=lym
e=e
ekftu=utfke
ns=sn
nzgw=wgzn
meiwcw=wcwiem
bpnxzpcxbm=mbxcpzxnpb
facyx=xycaf
mbkudd=ddukbm
whhxe=exhhw
sbmzrtwe=ewtrzmbs
jajquxikv=vkixuqjaj
lfamv=vmafl
hosiq=qisoh
zqouhozqc=cqzohuoqz
xfggj=jggfx
i=i
nuej=jeun
yzt=tzy
bmwcqzqwi=iwqzqcwmb
vmg=gmv
guyccs=sccyug
mxtai=iatxm
iq=qi
fmumlsbo=obslmumf
fl=lf
vy=yv
xsqgibnt=tnbigqsx
y=y
kcdsjboqg=gqobjsdck
tsypl=lpyst
ukorq=qroku
lfmeuoehbk=kbheouemfl
wnblsx=xslbnw
jb=bj
gaimkmck=kcmkmiag
volzlsko=okslzlov
rco=ocr
vihoedtqxr=rxqtdeohiv
bqteua=auetqb
g=g
ge=eg
wro=orw
nwij=jiwn
qacxirxs=sxrixcaq
bwhh=hhwb
gxhot=tohxg
cqr=rqc
a=a
rax=xar
gocbe=ebcog
bdntpzpv=vpzptndb
lnzukycfk=kfcykuznl
pbkzscfn=nfcszkbp
rptv=vtpr
axdiebaf=fabeidxa
vtda=adtv
t=t
lxrdwh=hwdrxl
gulyvju=ujvylug
lkaw=wakl
ssfh=hfss
dztrwi=iwrtzd
aizgf=fgzia
przn=nzrp
ctrjvyci=icyvjrtc
lkwfwsowu=uwoswfwkl
jcekb=bkecj
hmozyprkge=egkrpyzomh
hkjvynknhm=mhnknyvjkh
sfk=kfs
xijfbhjh=hjhbfjix
ldptlwgbz=zbgwltpdl
hkcbcmqv=vqmcbckh
ktezmfi=ifmzetk
oioyeiup=puieyoio
zlgxrm=mrxglz
vjk=kjv
w=w
fazjdaedec=cedeadjzaf
fp=pf
ggu=ugg
m=m
mf=fm
s=s
stjxfvzb=bzvfxjts
tptkqnbo=obnqktpt
bnirda=adrinb
scve=evcs
iywmnz=znmwyi
fhmwnedo=odenwmhf
nckhar=rahkcn
md=dm
qhz=zhq
fhbdli=ildbhf
uyiyjs=sjyiyu
yhjppiafyk=kyfaippjhy
byeougniw=winguoeyb
keoanjwc=cwjnaoek
eoev=veoe
l=l
bezmumo=omumzeb
pyhgkhj=jhkghyp
zphnh=hnhpz
ipgtjtjpk=kpjtjtgpi
oqqohjkg=gkjhoqqo
yqr=rqy
zswoixfik=kifxiowsz
eelcikrd=drkiclee
ywxsi=isxwy
ahujxx=xxjuha
nylivuzp=pzuvilyn
lvzcdxwkyc=cykwxdczvl
pj=jp
hlstkzdj=jdzktslh
buyxdk=kdxyub
tcou=uoct
mobzrturyp=pyrutrzbom
alvnoszyb=byzsonvla
zevra=arvez
lfpaugs=sguapfl
antxeirc=criextna
yiupnggdf=fdggnpuiy
qs=sq
r=r
hakmgsmeo=oemsgmkah
uwcsub=buscwu
gghvnjbobl=lbobjnvhgg
zvmmr=rmmvz
i=i
wyewngy=ygnweyw
yjrynd=dnyrjy
isuzdjlkvo=ovkljdzusi
ho=oh
bgkwcomdlm=mldmocwkgb
edgcjbj=jbjcgde
eimkkslbw=wblskkmie
zhmlc=clmhz
m=m
a=a
sya=ays
iecsakkyk=kykkascei
jatlhljfzk=kzfjlhltaj
msol=losm
uotsyhw=whystou
gxesagvw=wvgasexg
nz=zn
nbmzd=dzmbn
i=i
ednaqubn=nbuqande
emtxxan=naxxtme
qrwe=ewrq
iod=doi
cwoczabqpp=ppqbazcowc
tbed=debt
sjqjuudiz=ziduujqjs
bf=fb
zu=uz
qn=nq
czai=iazc
uaou=uoau
wgsrwik=kiwrsgw
rnbpzd=dzpbnr
sj=js
sjkrxh=hxrkjs
w=w
tt=tt
okqoxvjrwg=gwrjvxoqko
dkmcuvp=pvucmkd
zrby=ybrz
vlqzbqkxrt=trxkqbzqlv
mrmcklt=tlkcmrm
lwbwy=ywbwl
hefp=pfeh
eiva=avie
uicsybvo=ovbysciu
eirlrfl=lfrlrie
uhw=whu
ulucchcovf=fvochcculu
frelhykyga=agykyhlerf
zlay=yalz
bbgeslj=jlsegbb
aznsqunsr=rsnuqsnza
kfs=sfk
bktiuqig=giquitkb
dlhqeynvs=svnyeqhld
e=e
tqmggaby=ybaggmqt
nz=zn
tph=hpt
fzxablf=flbaxzf
emnlcqr=rqclnme
x=x
nlcgxn=nxgcln
du=ud
siqlkjlb=bljklqis
uughk=khguu
okytk=ktyko
ycfy=yfcy
yarljkra=arkjlray
hasomd=dmosah
pfj=jfp
fj=jf
iumytyvae=eavytymui
gdjaetioge=egoiteajdg
l=l
rzqdf=fdqzr
lawyvplx=xlpvywal
djdwin=niwdjd
exxns=snxxe
spx=xps
bxd=dxb
xpym=mypx
iyxuenoq=qoneuxyi
fchy=yhcf
tuexdcief=feicdxeut
edgvdgrd=drgdvgde
wzts=stzw
yozg=gzoy
ehdqhuduh=huduhqdhe
stlyefq=qfeylts
yvttxb=bxttvy
otdxspn=npsxdto
nxpcoxw=wxocpxn
ptp=ptp
btetgjeuc=cuejgtetb
nzdobad=dabodzn
osiazbt=tbzaiso
hcqvq=qvqch
rnt=tnr
xdqq=qqdx
jr=rj
pfmagc=cgamfp
yu=uy
eshzq=qzhse
alcxkvlxcw=wcxlvkxcla
hqrywkp=pkwyrqh
r=r
zgalz=zlagz
wqulux=xuluqw
yzwwlvcnz=zncvlwwzy
rjtdyuzzik=kizzuydtjr
j=j
maepjynosn=nsonyjpeam
kye=eyk
awclqf=fqlcwa
hukcmypb=bpymckuh
y=y
asl=lsa
yzqfls=slfqzy
vvxao=oaxvv
xmhf=fhmx
umzi=izmu
abdjlb=bljdba
jckisjjr=rjjsikcj
sfi=ifs
jlou=uolj
nor=ron
kmb=bmk
odxopsurv=vruspoxdo
w=w
qjsklxkr=rkxlksjq
lhuzuybou=uobyuzuhl
ridikzkpev=vepkzkidir
lmjhyufud=dufuyhjml
pwch=hcwp
xnluptx=xtpulnx
bkuzy=yzukb
vt=tv
wvocjttvjs=sjvttjcovw
bwx=xwb
tvhclrim=mirlchvt
tdddirnn=nnridddt
axy=yxa
rsgjx=xjgsr
ityrkc=ckryti
koq=qok
yncur=rucny
jxbamrp=prmabxj
o=o
bbcodhitjm=mjtihdocbb
kylo=olyk
qqeczmtdf=fdtmzceqq
yslmdn=ndmlsy
ghmkr=rkmhg
xwah=hawx
lqyyo=oyyql
lzjfvgkl=lkgvfjzl
yuweqrlgy=yglrqewuy
drjg=gjrd
autuabzck=kczbautua
cmcy=ycmc
z=z
dknheydzd=dzdyehnkd
pjbpgwj=jwgpbjp
th=ht
ry=yr
rnusas=sasunr
pjr=rjp
lwj=jwl
aua=aua
ugdjd=djdgu
wdh=hdw
nxo=oxn
teqwki=ikwqet
zqwexiznra=arnzixewqz
nacagu=ugacan
shs=shs
bnj=jnb
qtc=ctq
sotx=xtos
iarul=lurai
shilbkc=ckblihs
iwvi=ivwi
jypnm=mnpyj
zxxx=xxxz
jbwknapoab=baopankwbj
qz=zq
aw=wa
uzzkia=aikzzu
rbgmsawz=zwasmgbr
ug=gu
jtlommqvg=gvqmmoltj
jbizcl=lczibj
joom=mooj
eybnogxxhd=dhxxgonbye
ywqkxvbh=hbvxkqwy
jcbisxnlh=hlnxsibcj
jgt=tgj
keu=uek
twmto=otmwt
cphdms=smdhpc
ohvcfxu=uxfcvho
hwu=uwh
tv=vt
mfnruiiwvk=kvwiiurnfm
fvtfc=cftvf
detfto=otfted
p=p
vvnlpkqpjo=ojpqkplnvv
apxwscph=hpcswxpa
tlovnyf=fynvolt
amakovzhu=uhzvokama
lhuzolw=wlozuhl
gozsv=vszog
rttfscr=rcsfttr
yzkpq=qpkzy
dgq=qgd
lxrhzq=qzhrxl
vbvudkyd=dykduvbv
ps=sp
ontuqg=gqutno
vsdqletqh=hqtelqdsv
bb=bb
omidncge=egcndimo
nmhwxjvbfj=jfbvjxwhmn
detohnigl=lginhoted
jkkcqv=vqckkj
uaeebo=obeeau
u=u
yfcxtuczi=izcutxcfy
cyzmlgdeaf=faedglmzyc
zsmkh=hkmsz
q=q
dp=pd
hryip=piyrh
fayyxbmlr=rlmbxyyaf
mow=wom
oyimpodhd=dhdopmiyo
hgjsxaitox=xotiaxsjgh
o=o
f=f
awwumkgfik=kifgkmuwwa
h=h
j=j
mtqz=zqtm
qp=pq
hy=yh
ungz=zgnu
mjef=fejm
vtqe=eqtv
iwlpkdbbx=xbbdkplwi
irgqc=cqgri
yinds=sdniy
ajzzke=ekzzja
dcrtenp=pnetrcd
axxcmlti=itlmcxxa
zhzknedonq=qnodenkzhz
ts=st
pqqp=pqqp
wamide=edimaw
lgvxczfy=yfzcxvgl
myjcfsu=usfcjym
pjhrkirqvl=lvqrikrhjp
viypgpvrm=mrvpgpyiv
fmlaioychq=qhcyoialmf
scz=zcs
jw=wj
pzlofu=ufolzp
rpktfu=uftkpr
powiy=yiwop
pa=ap
yu=uy
wkusosa=asosukw
efew=wefe
t=t
hbaz=zabh
wdriztcru=urctzirdw
krfdth=htdfrk
cgdrnv=vnrdgc
zber=rebz
tosgosfs=sfsogsot
ukttndcap=pacdnttku
hcssbmvdf=fdvmbssch
ub=bu
pkikzi=izkikp
osfoeezmxx=xxmzeeofso
zmcedxpk=kpxdecmz
rsgecmyff=ffymcegsr
mjchgb=bghcjm
jrmoxq=qxomrj
yasrd=drsay
tfafqkjtc=ctjkqfaft
zgksbrw=wrbskgz
bhwftgqf=fqgtfwhb
zogbxvngx=xgnvxbgoz
vgimlb=blmigv
denh=hned
lstkxkkv=vkkxktsl
yxcngkvcw=wcvkgncxy
rzibnyq=qynbizr
s=s
fkpktz=ztkpkf
gmcldpjgg=ggjpdlcmg
axx=xxa
qpid=dipq
mdrws=swrdm
dekmliwro=orwilmked
shpgajsb=bsjagphs
wf=fw
cq=qc
mm=mm
mabyxyk=kyxybam
vfaabzl=lzbaafv
ivojidu=udijovi
nutaha=ahatun
doaiffu=uffiaod
ph=hp
cgzlwqmwxq=qxwmqwlzgc
cd=dc
mssbhoseu=uesohbssm
fpoth=htopf
kdv=vdk
vhfqsffl=lffsqfhv
dlsnsledp=pdelsnsld
fjby=ybjf
uywq=qwyu
bjhohsafw=wfashohjb
crgw=wgrc
tboxqddbjm=mjbddqxobt
ggmh=hmgg
ohzuxvndg=gdnvxuzho
uvifxqf=fqxfivu
cmfau=uafmc
snfbrrpog=goprrbfns
mcehysb=bsyhecm
tydrlsku=ukslrdyt
ezxq=qxze
etfcekle=elkecfte
rfim=mifr
mpsatkljj=jjlktaspm
u=u
djbpbzjh=hjzbpbjd
humdxvmh=hmvxdmuh
m=m
kayhnwm=mwnhyak
rlknwixa=axiwnklr
zdzsawb=bwaszdz
ouzwic=ciwzuo
kivtvvbrxn=nxrbvvtvik
jqzudauqzn=nzquaduzqj
hesfkjnm=mnjkfseh
widtz=ztdiw
ekbpt=tpbke
ojcjyzjbsm=msbjzyjcjo
xa=ax
vnwpxgbwb=bwbgxpwnv
gukyqiya=ayiqykug
jvyuoawr=rwaouyvj
buoincto=otcnioub
xvswjrp=prjwsvx
d=d
yjx=xjy
rxmam=mamxr
qe=eq
sxd=dxs
nwrrz=zrrwn
lbwke=ekwbl
whqrtbtw=wtbtrqhw
amhfjkvqu=uqvkjfhma
zkwa=awkz
uadw=wdau
qh=hq
gajbd=dbjag
usclph=hplcsu
uyzln=nlzyu
kbntisa=asitnbk
pgwbjih=hijbwgp
wow=wow
wdqxnti=itnxqdw
d=d
uviu=uivu
baceq=qecab
glojvwb=bwvjolg
otmqj=jqmto
ytlojct=tcjolty
ugxmfd=dfmxgu
oqzm=mzqo
osx=xso
wgp=pgw
eldxxnhsx=xshnxxdle
ehn=nhe
cns=snc
dnerftv=vtfrend
syetosnfhq=qhfnsoteys
d=d
s=s
lwnilye=eylinwl
bnmwfuvb=bvufwmnb
wlmw=wmlw
ivuje=ejuvi
ketcficdlz=zldcifctek
q=q
qxm=mxq
wmvsehre=erhesvmw
u=u
js=sj
zwsttrfg=gfrttswz
jvt=tvj
gebzqrmsk=ksmrqzbeg
rmaoiouxcx=xcxuoioamr
menpe=epnem
dgl=lgd
wa=aw
rqqm=mqqr
awnikaf=fakinwa
gezvwntt=ttnwvzeg
ps=sp
tuke=ekut
tpkf=fkpt
lnwwex=xewwnl
jfaoeib=bieoafj
xgqi=iqgx
zprr=rrpz
mopdnoepw=wpeondpom
w=w
bjkghoj=johgkjb
jnn=nnj
rwzccwec=cewcczwr
mnqggwrqvu=uvqrwggqnm
rtgbjecopd=dpocejbgtr
qgioqepwr=rwpeqoigq
eswktt=ttkwse
p=p
vvuvxszasw=wsazsxvuvv
xtfvo=ovftx
mdvsyhsc=cshysvdm
nzlrosfju=ujfsorlzn
txk=kxt
zkpvkp=pkvpkz
abpzb=bzpba
ywoqhnuqr=rqunhqowy
r=r
erzajhj=jhjazre
mcffmrnhml=lmhnrmffcm
ftw=wtf
ykbo=obky
pdinpkzkj=jkzkpnidp
spdcd=dcdps
imwhhqc=cqhhwmi
uozd=dzou
ioycgwh=hwgcyoi
vewchrcscg=gcscrhcwev
utr=rtu
brk=krb
affkr=rkffa
bbm=mbb
ua=au
k=k
bbm=mbb
nh=hn
gtopbrdni=indrbpotg
igvx=xvgi
pmmyte=etymmp
egn=nge
lev=vel
uzqshxgq=qgxhsqzu
ycxntelspw=wpsletnxcy
xnkkj=jkknx
xjsdhan=nahdsjx
chdylt=tlydhc
btzzcsfpk=kpfsczztb
sp=ps
egupz=zpuge
ndrxynj=jnyxrdn
wodbj=jbdow
pskujew=wejuksp
rrwlhspyq=qypshlwrr
wluadythui=iuhtydaulw
absulkr=rklusba
tmf=fmt
huj=juh
afvpammd=dmmapvfa
bsvojcyb=bycjovsb
cfgvfyizaa=aaziyfvgfc
zzh=hzz
tit=tit
diyav=vayid
nfjqfs=sfqjfn
oflaufr=rfualfo
ycyrbgepe=epegbrycy
fura=aruf
kos=sok
dtzpimuoyr=ryoumipztd
jtq=qtj
bdm=mdb
amvz=zvma
deaydmu=umdyaed
edhnqejjl=ljjeqnhde
suk=kus
mjxtzi=iztxjm
l=l
nrsawunazg=gzanuwasrn
trjtsgui=iugstjrt
dtnvdyjhy=yhjydvntd
f=f
xkazmlgjc=cjglmzakx
zmcyrizuu=uuzirycmz
aw=wa
fs=sf
twfxotc=ctoxfwt
vdzw=wzdv
zalfhlrxjn=njxrlhflaz
sn=ns
iwuulqj=jqluuwi
igka=akgi
uuqgjvgia=aigvjgquu
manugppw=wppgunam
dhuta=atuhd
osnopzu=uzponso
lpjg=gjpl
xgegawhqj=jqhwagegx
qrzjghpg=gphgjzrq
ttmfqqpub=bupqqfmtt
ddjot=tojdd
cyuk=kuyc
escu=ucse
qizojxtpm=mptxjoziq
s=s
ubdh=hdbu
uowv=vwou
fzrwmsjv=vjsmwrzf
x=x
lk=kl
yqe=eqy
nbfsbe=ebsfbn
tbxmdbe=ebdmxbt
ob=bo
yc=cy
aceapcu=ucpaeca
hk=kh
d=d
xtbum=mubtx
dqfkad=dakfqd
zshljnhn=nhnjlhsz
jpcnngnlif=filngnncpj
ej=je
zxb=bxz
swgocqcr=rcqcogws
vrh=hrv
og=go
xnknbetmu=umtebnknx
lyiw=wiyl
e=e
xnkmghpds=sdphgmknx
vcuzzxnrsr=rsrnxzzucv
hojnace=ecanjoh
genv=vneg
emdqqqnk=knqqqdme
b=b
yi=iy
iffuinxe=exniuffi
kkwk=kwkk
u=u
oxgzp=pzgxo
wy=yw
pbqw=wqbp
utcnfrjd=djrfnctu
viejjsln=nlsjjeiv
xw=wx
ubkmq=qmkbu
fjv=vjf
hb=bh
fn=nf
jpcvd=dvcpj
kxfztgtv=vtgtzfxk
h=h
uokmyctmt=tmtcymkou
fguuuyopq=qpoyuuugf
ilnmop=pomnli
vn=nv
bxvpdziu=uizdpvxb
uihzzqlg=glqzzhiu
uwngptijmm=mmjitpgnwu
sp=ps
mbmewmui=iumwembm
zjygi=igyjz
e=e
swjihf=fhijws
n=n
ktgppptnit=tintpppgtk
t=t
pmyfwn=nwfymp
pjmthtc=cthtmjp
ibqfpym=mypfqbi
h=h
ysfx=xfsy
aotvxk=kxvtoa
nlnpfrkb=bkrfpnln
wt=tw
vvoytzpim=mipztyovv
yzfp=pfzy
fniwt=twinf
hmu=umh
xywtqget=tegqtwyx
hjayopgk=kgpoyajh
kg=gk
uwntsrhhco=ochhrstnwu
vdf=fdv
wwlnq=qnlww
oxzkfrrx=xrrfkzxo
vyv=vyv
xquzeqgduy=yudgqezuqx
xpmza=azmpx
pmayq=qyamp
feclkatkw=wktaklcef
makqrcp=pcrqkam
veue=euev
rro=orr
ykrhl=lhrky
nzpqhfpakd=dkapfhqpzn
xnae=eanx
qvgqnk=knqgvq
kqxb=bxqk
zmmcxqkqwt=twqkqxcmmz
sdnefaacb=bcaafends
ypmslq=qlsmpy
inevndnbgv=vgbndnveni
mevviczuar=rauzcivvem
vs=sv
yynvzadyn=nydazvnyy
fmfk=kfmf
ixa=axi
kvthsg=gshtvk
bpjgsrq=qrsgjpb
vt=tv
ujw=wju
eefaef=feafee
wuzdyff=ffydzuw
pgfsml=lmsfgp
djyrpapfl=lfpapryjd
a=a
lornmwp=pwmnrol
eics=scie
vg=gv
fofikwgy=ygwkifof
padf=fdap
uiybptrpg=gprtpbyiu
qgrrnjjpmx=xmpjjnrrgq
ofvyb=byvfo
tyixvc=cvxiyt
nl=ln
ibjan=najbi
chua=auhc
uqz=zqu
zjgned=dengjz
qjzrhx=xhrzjq
tme=emt
lym=myl
fy=yf
k=k
v=v
bkbev=vebkb
ivgix=xigvi
fncedjl=ljdecnf
xjzgarcqs=sqcragzjx
srxcjija=ajijcxrs
m=m
aqdsonds=sdnosdqa
c=c
gnx=xng
rxoop=pooxr
lbtq=qtbl
jidwejxiv=vixjewdij
xwvxrsy=ysrxvwx
ox=xo
qbhve=evhbq
kqk=kqk
qalj=jlaq
vea=aev
avm=mva
fkq=qkf
rvenau=uanevr
ehaftrcr=rcrtfahe
xqtsk=kstqx
mcsvjgu=ugjvscm
jlrf=frlj
uhlquhfpg=gpfhuqlhu
qqctuznq=qnzutcqq
pptsaxgn=ngxastpp
b=b
pqgkacrzy=yzrcakgqp
ulhzzxoq=qoxzzhlu
vywvrbahp=phabrvwyv
mawstkbtmu=umtbktswam
zkzc=czkz
sxy=yxs
o=o
dbjggcxmre=ermxcggjbd
sifrvoejwh=hwjeovrfis
lwtq=qtwl
nnn=nnn
qfg=gfq
urem=meru
rws=swr
mfigryglov=volgyrgifm
icawreymrh=hrmyerwaci
vn=nv
w=w
mfmxxcgt=tgcxxmfm
qzk=kzq
yoqpaydg=gdyapqoy
bingvaumo=omuavgnib
ibomv=vmobi
ojgattd=dttagjo
izxhpi=iphxzi
sbiveopwb=bwpoevibs
jldz=zdlj
a=a
uumbfcpom=mopcfbmuu
chtpdkkqpm=mpqkkdpthc
a=a
mklvnwh=hwnvlkm
afgjasacq=qcasajgfa
prluqkxlnx=xnlxkqulrp
wafuuscv=vcsuufaw
lvwbkgj=jgkbwvl
zpbiidb=bdiibpz
ucx=xcu
gkqzslzaz=zazlszqkg
rdakfg=gfkadr
loehxfx=xfxheol
mzutdmoxd=dxomdtuzm
ombgzhx=xhzgbmo
xlabpkmh=hmkpbalx
wvnapdpv=vpdpanvw
rxif=fixr
sof=fos
hyldn=ndlyh
booszue=euzsoob
eouzy=yzuoe
yiwxo=oxwiy
uwsrio=oirswu
risxsvr=rvsxsir
mwmd=dmwm
hkqlj=jlqkh
n=n
xunixhpf=fphxinux
yorlpiec=ceiplroy
reeyy=yyeer
diiwhvhdy=ydhvhwiid
vepzi=izpev
aiohknum=munkhoia
rjgvjgdf=fdgjvgjr
m=m
vfx=xfv
a=a
dzmn=nmzd
vbaoq=qoabv
xniaasglc=clgsaainx
h=h
iai=iai
vzodcdazim=mizadcdozv
impdjknfl=lfnkjdpmi
eqoleaef=feaeloqe
k=k
hcpor=ropch
dfrvbi=ibvrfd
rvjjvbho=ohbvjjvr
eln=nle
bqug=guqb
fpg=gpf
vktojmmhaj=jahmmjotkv
rdldyum=muydldr
ugoq=qogu
dio=oid
wysc=csyw
ftmyzg=gzymtf
znn=nnz
qkrek=kerkq
fkflad=dalfkf
hiul=luih
qmefaj=jafemq
df=fd
btmewihoex=xeohiwemtb
xml=lmx
ntuueohv=vhoeuutn
spmgec=cegmps
brbk=kbrb
klmktksmvs=svmsktkmlk
yzwfjgmsvv=vvsmgjfwzy
mji=ijm
p=p
vakpxpmg=gmpxpkav
cs=sc
dn=nd
hqi=iqh
tkdfol=lofdkt
mg=gm
tbkuqdlouh=huoldqukbt
hpl=lph
bwqs=sqwb
eynknpyz=zypnknye
fny=ynf
oyy=yyo
yfn=nfy
requxnbwhb=bhwbnxuqer
t=t
ksw=wsk
mpfw=wfpm
crl=lrc
xdtddfjw=wjfddtdx
qbjiczzzd=dzzzcijbq
o=o
uh=hu
ygwazf=fzawgy
koc=cok
jjdy=ydjj
klubcb=bcbulk
jjnmbpizcq=qczipbmnjj
hgocq=qcogh
ilzfvq=qvfzli
uui=iuu
wvhs=shvw
p=p
tqpxlrys=syrlxpqt
tanonwa=awnonat
dd=dd
unnmvxlul=lulxvmnnu
s=s
fuwtd=dtwuf
escwrmkd=dkmrwcse
ohjbsmyf=fymsbjho
w=w
fvqajs=sjaqvf
nwzijczm=mzcjizwn
a=a
ghzyvisnb=bnsivyzhg
e=e
fmtdoahko=okhaodtmf
wjhb=bhjw
xs=sx
shxnsyr=rysnxhs
ykccyhu=uhyccky
gr=rg
kqaeayz=zyaeaqk
cujzqhbxu=uxbhqzjuc
g=g
tc=ct
obvbmgap=pagmbvbo
mum=mum
lye=eyl
q=q
bau=uab
nnwz=zwnn
ixoutwdzc=czdwtuoxi
awsrlap=palrswa
poq=qop
xgk=kgx
u=u
ezwkvtikzk=kzkitvkwze
tfgy=ygft
ol=lo
vqhmeq=qemhqv
osf=fso
jiuxx=xxuij
ftvp=pvtf
h=h
hewbvjcq=qcjvbweh
birc=crib
sktex=xetks
f=f
rxvnfxrs=srxfnvxr
xyqvcwwn=nwwcvqyx
idchery=yrehcdi
f=f
jw=wj
jhitkdvdm=mdvdktihj
k=k
ebipbhqj=jqhbpibe
rgawpkgl=lgkpwagr
curdutffrc=crfftudruc
rorsulbks=skblusror
axcokaieyg=gyeiakocxa
c=c
mee=eem
h=h
ylxnrxb=bxrnxly
jbraa=aarbj
wovnrpe=eprnvow
txraazj=jzaarxt
sbqzoco=ocozqbs
egtnauamxi=ixmauantge
pcze=ezcp
eepg=gpee
lzfijrb=brjifzl
wrgc=cgrw
pgznqs=sqnzgp
mwyzjrtx=xtrjzywm
d=d
wv=vw
auoklwozwm=mwzowlkoua
qhhoqyscyx=xycsyqohhq
sfrod=dorfs
v=v
bacp=pcab
ncrzral=larzrcn
qw=wq
xafxugojz=zjoguxfax
q=q
hkfko=okfkh
ps=sp
qcrrontgq=qgtnorrcq
fyighfthdy=ydhtfhgiyf
vraq=qarv
ibjnpunbsg=gsbnupnjbi
rqnvnuh=hunvnqr
iebp=pbei
l=l
ur=ru
uzwapqf=fqpawzu
gxmgheohw=whoehgmxg
yzsiizqwp=pwqziiszy
jsrwq=qwrsj
nzgjkc=ckjgzn
j=j
smwz=zwms
jgorh=hrogj
y=y
iune=enui
yunaaou=uoaanuy
ouqcxpln=nlpxcquo
gvkial=laikvg
rmcssmdg=gdmsscmr
t=t
tpqipggls=slggpiqpt
bhkqh=hqkhb
zeikkeawfr=rfwaekkiez
cq=qc
ds=sd
yeqbhxw=wxhbqey
fmjlzs=szljmf
lgs=sgl
lb=bl
fglezy=yzelgf
akgphnezer=rezenhpgka
igmrlvd=dvlrmgi
pxdctlvm=mvltcdxp
d=d
tnnqbr=rbqnnt
a=a
qjpbnwlczx=xzclwnbpjq
ip=pi
iyr=ryi
ydf=fdy
wdjjzm=mzjjdw
henqb=bqneh
cftldan=nadltfc
kjqc=cqjk
oh=ho
yui=iuy
cjdgikwtoe=eotwkigdjc
ypchgkiqdg=gdqikghcpy
rfsqh=hqsfr
di=id
crm=mrc
rptj=jtpr
gbbvizt=tzivbbg
u=u
l=l
sdgwaux=xuawgds
f=f
ie=ei
znm=mnz
ioi=ioi
xouwmrfve=evfrmwuox
puzkjh=hjkzup
dclolxri=irxlolcd
dijvyapsl=lspayvjid
vlpenwq=qwneplv
rxsmffqi=iqffmsxr
slajjdcr=rcdjjals
vsybofyki=ikyfobysv
nfhcu=uchfn
jpnrsfq=qfsrnpj
nzawmdvh=hvdmwazn
dsmuzwchk=khcwzumsd
nz=zn
nfv=vfn
gafwdtg=gtdwfag
y=y
efw=wfe
ecjqiswba=abwsiqjce
neffnn=nnffen
i=i
tuxygxhudi=iduhxgyxut
poarzwg=gwzraop
yxlqb=bqlxy
mlooekl=lkeoolm
hlc=clh
dawm=mwad
u=u
gnyxky=ykxyng
tuazjb=bjzaut
yzja=ajzy
yjbvzmytrz=zrtymzvbjy
w=w
ieuksseycn=ncyesskuei
jcm=mcj
njziq=qizjn
wwwhgbciog=goicbghwww
hvd=dvh
y=y
lwcynf=fnycwl
f=f
hvnizlknj=jnklzinvh
yy=yy
idk=kdi
nd=dn
jdrdek=kedrdj
vjlb=bljv
tvjmp=pmjvt
nbog=gobn
a=a
ytfbb=bbfty
kt=tk
cz=zc
tl=lt
z=z
gmxn=nxmg
mkout=tuokm
fmp=pmf
xqrc=crqx
pa=ap
wblbt=tblbw
ic=ci
syo=oys
maqex=xeqam
cfrlbdrst=tsrdblrfc
yiahmysmeo=oemsymhaiy
ykhyqswp=pwsqyhky
xekaureoc=coeruakex
hu=uh
kaawk=kwaak
lxun=nuxl
hqwrgnoxgh=hgxongrwqh
eukhtev=vethkue
kjeycep=pecyejk
spivpakmke=ekmkapvips
hewxwbbx=xbbwxweh
grjaxmgjxr=rxjgmxajrg
fdmdfv=vfdmdf
xs=sx
orthgrekya=aykerghtro
rbmrcn=ncrmbr
r=r
ohh=hho
ghbmwvivr=rvivwmbhg
pnwelgu=uglewnp
g=g
ov=vo
kdcwj=jwcdk
ezthyh=hyhtze
bmstr=rtsmb
fos=sof
kxlyszwt=twzsylxk
pqizxiop=poixziqp
m=m
x=x
u=u
irawsyt=tyswari
wsmssvm=mvssmsw
gvrnkonj=jnoknrvg
bgpwb=bwpgb
fqrysvlyap=paylvsyrqf
qrfofv=vfofrq
gc=cg
fo=of
vupotxsj=jsxtopuv
mf=fm
pjdwt=twdjp
jb=bj
faon=noaf
bjkgitiwh=hwitigkjb
pdrwjr=rjwrdp
ewxova=avoxwe
ba=ab
eyanbytw=wtybnaye
x=x
bcfex=xefcb
ngoi=iogn
bemav=vameb
pnkdz=zdknp
p=p
nppxizlsf=fslzixppn
jvexecn=ncexevj
ma=am
ahv=vha
tgumttrg=grttmugt
ijzpiatu=utaipzji
rfylyuohxy=yxhouylyfr
z=z
dngtam=matgnd
otspwpt=tpwpsto
oiz=zio
qjdl=ldjq
gxzvprxcjq=qjcxrpvzxg
gjjf=fjjg
hocfvjn=njvfcoh
oowsvwvhkm=mkhvwvswoo
pwcajlxvs=svxljacwp
hzyuy=yuyzh
zbnpdph=hpdpnbz
uojr=rjou
pylvwp=pwvlyp
nlkyk=kykln
mw=wm
mkhht=thhkm
dawgv=vgwad
lsh=hsl
kkydloaeof=foeaoldykk
pugehllm=mllhegup
odm=mdo
qnvaqoru=uroqavnq
ojpyhhtbj=jbthhypjo
l=l
qpukgjqox=xoqjgkupq
eajycu=ucyjae
ypyyupo=opuyypy
atit=tita
ntqidc=cdiqtn
aucko=okcua
epp=ppe
k=k
zpwwmox=xomwwpz
xvy=yvx
uigyccmlx=xlmccygiu
pslpvp=pvplsp
tccjwvx=xvwjcct
hguthtfu=ufthtugh
nunmuukf=fkuumnun
ennmv=vmnne
jr=rj
ovjrem=merjvo
blbi=iblb
q=q
jedudxddix=xiddxdudej
vb=bv
obyyig=giyybo
elxstcuqw=wquctsxle
o=o
ajdefq=qfedja
aqsajnvf=fvnjasqa
egjog=gojge
whehc=chehw
idoesxy=yxseodi
sy=ys
d=d
tf=ft
yqdlvle=elvldqy
keifkijt=tjikfiek
crgdutfago=ogaftudgrc
ziiv=viiz
ecnyujln=nljuynce
xdqlqc=cqlqdx
uflindpuzk=kzupdnilfu
or=ro
qme=emq
vqa=aqv
m=m
prnaw=wanrp
ffixwuml=lmuwxiff
rmfkmzuyr=ryuzmkfmr
ntas=satn
v=v
lmhqc=cqhml
oxbzbdixnn=nnxidbzbxo
uoe=eou
noe=eon
g=g
wqc=cqw
rdkzily=ylizkdr
npi=ipn
rcpvgxni=inxgvpcr
feylicrk=krcilyef
wcareicw=wcieracw
vjxc=cxjv
kwqtz=ztqwk
biexwe=ewxeib
nfgqptjiop=poijtpqgfn
yskzj=jzksy
ewoqb=bqowe
zxiocmi=imcoixz
ytq=qty
davjvpe=epvjvad
yldxeyr=ryexdly
kgmewbuab=baubwemgk
izuepvzu=uzvpeuzi
mz=zm
wvis=sivw
h=h
jrn=nrj
mnx=xnm
hsogkvof=fovkgosh
nooahrbn=nbrhaoon
zpnzagzw=wzgaznpz
nkffamakln=nlkamaffkn
jddgh=hgddj
xgetcx=xctegx
qdvrczpunb=bnupzcrvdq
vrnyclgzwp=pwzglcynrv
dpzxwrzh=hzrwxzpd
ijrmeq=qemrji
k=k
bacoex=xeocab
gsruhm=mhursg
rcmrt=trmcr
spqqqrfkyp=pykfrqqqps
wbutoj=jotubw
ivvpmqyvfk=kfvyqmpvvi
hqgfrgroqc=cqorgrfgqh
zutycso=oscytuz
nyrs=sryn
kkgeqb=bqegkk
cyeglskf=fkslgeyc
idskhsnsh=hsnshksdi
jnrvmbrwe=ewrbmvrnj
nfilpptam=matpplifn
xef=fex
akvcuydnna=anndyucvka
gtr=rtg
d=d
yxjwfhp=phfwjxy
b=b
lxzltr=rtlzxl
fn=nf
tjnch=hcnjt
jo=oj
knajbrth=htrbjank
ssx=xss
qzqgoaeuw=wueaogqzq
coeabxxdf=fdxxbaeoc
xuosbfprtw=wtrpfbsoux
xxqk=kqxx
fv=vf
ellexgce=ecgxelle
uhn=nhu
uppusai=iasuppu
e=e
mfvwqorup=puroqwvfm
vugmiolka=akloimguv
afujh=hjufa
zcnbyzgg=ggzybncz
nupfaqr=rqafpun
r=r
vruu=uurv
lr=rl
nsjfpvrykv=vkyrvpfjsn
hvpj=jpvh
alskmgwzg=gzwgmksla
gzicojiehl=lheijocizg
kusvbv=vbvsuk
tv=vt
zq=qz
wcxmxtwsgb=bgswtxmxcw
nndyiw=wiydnn
zdh=hdz
ez=ze
xksnbcag=gacbnskx
ymovrpx=xprvomy
lnagsgbjpu=upjbgsganl
w=w
ldqdf=fdqdl
xnjcf=fcjnx
gjtoqrw=wrqotjg
sgwurrlup=pulrruwgs
v=v
vgvcfesw=wsefcvgv
iw=wi
vcjiawm=mwaijcv
yxgvlqv=vqlvgxy
upufqimmjg=gjmmiqfupu
toteyktvi=ivtkyetot
mkemlkruyv=vyurklmekm
ct=tc
eh=he
gwngfknn=nnkfgnwg
vprfdnu=undfrpv
ibxv=vxbi
ypqzhvjkxb=bxkjvhzqpy
p=p
parl=lrap
ugbht=thbgu
iaxvf=fvxai
chma=amhc
ecill=llice
plgc=cglp
k=k
xylamaiyx=xyiamalyx
kbongrcog=gocrgnobk
tm=mt
et=te
s=s
kezqlnxwn=nwxnlqzek
ybuzkwh=hwkzuby
jywkige=egikwyj
luux=xuul
yvhsso=osshvy
kmdgojmz=zmjogdmk
f=f
ukrfjri=irjfrku
gg=gg
cpfcbgyjd=djygbcfpc
ksmdp=pdmsk
nnbtndq=qdntbnn
xnz=znx
hrtava=avatrh
qjcb=bcjq
dbrnw=wnrbd
uvlf=flvu
x=x
wlsrtu=utrslw
eccivlhs=shlvicce
ndq=qdn
x=x
flacve=evcalf
abcw=wcba
tamvdzydnh=hndyzdvmat
smac=cams
i=i
t=t
abmywqtol=lotqwymba
kqzngf=fgnzqk
hreosdb=bdsoerh
p=p
xlmnk=knmlx
qrm=mrq
xo=ox
yzcweggk=kggewczy
saces=secas
s=s
xawgxnvytc=ctyvnxgwax
d=d
osj=jso
wx=xw
wbwhn=nhwbw
zrzii=iizrz
mywrlbfmne=enmfblrwym
fufmbppnah=hanppbmfuf
uyat=tayu
gkwnivcm=mcvinwkg
mkq=qkm
hplyre=erylph
huxlv=vlxuh
mo=om
dmmcf=fcmmd
fvtuoss=ssoutvf
goyyff=ffyyog
kdttdkqwls=slwqkdttdk
kfmksjfitw=wtifjskmfk
xpkvfzrqid=diqrzfvkpx
c=c
rtlvigq=qgivltr
szfmtcdpj=jpdctmfzs
fquxdo=odxuqf
wduqfa=afqudw
ipkpsd=dspkpi
oefeh=hefeo
ipy=ypi
ozridg=gdirzo
n=n
twcs=scwt
ognyskcyr=rycksyngo
ethe=ehte
dhrecu=ucerhd
wybjscc=ccsjbyw
mxbgrjkfqg=gqfkjrgbxm
mcbznikq=qkinzbcm
cvt=tvc
ntzuqkpyr=rypkquztn
jwpf=fpwj
gvzuillrce=ecrlliuzvg
mrvsikydkl=lkdykisvrm
nvkojpcf=fcpjokvn
wnfsfdy=ydfsfnw
hjqxyna=anyxqjh
kdhggwso=oswgghdk
nd=dn
vkwv=vwkv
ugodce=ecdogu
xllkeecaq=qaceekllx
d=d
jqgiccszkz=zkzsccigqj
vjrsuaopg=gpoausrjv
qihgopxw=wxpoghiq
k=k
fhyt=tyhf
nxuqbpspjm=mjpspbquxn
qlbifb=bfiblq
oiai=iaio
rcw=wcr
ytzsulusto=otsuluszty
uruxnmp=pmnxuru
csi=isc
pdgjzu=uzjgdp
m=m
qwxkwc=cwkxwq
pvtk=ktvp
crrli=ilrrc
ypelnuruc=curunlepy
utgunybbc=cbbynugtu
qril=lirq
gxnlcu=uclnxg
drnd=dnrd
fmgzs=szgmf
sluj=juls
yzvdgh=hgdvzy
zzj=jzz
aipmuodwkq=qkwdoumpia
xdlkpvcuz=zucvpkldx
maefg=gfeam
eaglqhjnc=cnjhqlgae
goxatvmkwu=uwkmvtaxog
wourgod=dogruow
s=s
r=r
el=le
wxsdbfvum=muvfbdsxw
gcwk=kwcg
ghq=qhg
hlxtwxhe=ehxwtxlh
itvxtnknn=nnkntxvti
aejb=bjea
rsfqw=wqfsr
kwhgwroh=horwghwk
uftxgcp=pcgxtfu
eml=lme
rutlalcdyg=gydclaltur
gogasy=ysagog
unyga=agynu
gvcbju=ujbcvg
vuxxjhnjvu=uvjnhjxxuv
zpuq=qupz
jybkrdue=eudrkbyj
gwnv=vnwg
smtl=ltms
rhynerpga=agprenyhr
btb=btb
kz=zk
tzeyfv=vfyezt
ndbexqrl=lrqxebdn
ytrtxkpmy=ympkxtrty
t=t
n=n
rpdajzlp=plzjadpr
g=g
jnbebe=ebebnj
lo=ol
yeqew=weqey
qxwdyatjy=yjtaydwxq
rgqihitx=xtihiqgr
jgokadvn=nvdakogj
qdukoaa=aaokudq
ycbzaqjrw=wrjqazbcy
bomy=ymob
cjzhakas=sakahzjc
dnlij=jilnd
yvizrm=mrzivy
kqh=hqk
x=x
qpao=oapq
yqrii=iirqy
zpjpp=ppjpz
kgtrlcb=bclrtgk
qojhtft=tfthjoq
samyi=iymas
taggzc=czggat
rafsu=usfar
xbfzkj=jkzfbx
qqp=pqq
wqlvowd=dwovlqw
xsq=qsx
rscfrxhyi=iyhxrfcsr
jmdzvyj=jyvzdmj
lwavbx=xbvawl
jrlo=olrj
ufficfotrk=krtofciffu
nvvdvts=stvdvvn
c=c
liejjqrsmo=omsrqjjeil
rugxba=abxgur
rhsbihbma=ambhibshr
zojr=rjoz
vdvp=pvdv
yviuqhwvm=mvwhquivy
pxdkxwlp=plwxkdxp
xcrwz=zwrcx
r=r
teds=sdet
rzqrmihphs=shphimrqzr
aipdjlhox=xohljdpia
peatjej=jejtaep
cd=dc
prkbtcu=uctbkrp
gbdadcdj=jdcdadbg
dhxgdqgvo=ovgqdgxhd
hohkqham=mahqkhoh
m=m
jz=zj
bzwy=ywzb
wxay=yaxw
c=c
uetq=qteu
a=a
jgif=figj
osbedkyua=auykdebso
vgusatniyq=qyintasugv
adkuq=qukda
mghahlw=wlhahgm
osealwavcs=scvawlaeso
kgboxn=nxobgk
z=z
wtxbtyu=uytbxtw
zd=dz
plsxxxigf=fgixxxslp
tqx=xqt
gksystv=vtsyskg
hirpqpc=cpqprih
d=d
mstdbslk=klsbdtsm
tj=jt
vgqlbld=dlblqgv
t=t
tashci=ichsat
wwvmsweyeu=ueyewsmvww
pggxoc=coxggp
ujadorcolm=mlocrodaju
kxelkeadhh=hhdaeklexk
utvvd=dvvtu
qvi=ivq
y=y
hluayqf=fqyaulh
bpykvkz=zkvkypb
lghtedn=ndethgl
ihheene=eneehhi
fhdmvgmbc=cbmgvmdhf
eabfibcgjt=tjgcbifbae
hzvdqnnvpl=lpvnnqdvzh
oytwggw=wggwtyo
csdyvadxzi=izxdavydsc
dmhxbf=fbxhmd
vnqwit=tiwqnv
xkzgp=pgzkx
niwrmtak=katmrwin
bwqulro=orluqwb
nmhpchk=khcphmn
pxbk=kbxp
ffpgwuroe=eoruwgpff
jh=hj
z=z
zjoxebu=ubexojz
g=g
lqddzirsli=ilsrizddql
zxsnvpg=gpvnsxz
uiimm=mmiiu
p=p
oslftvviwa=awivvtflso
wn=nw
xeaosm=msoaex
lsqijvgusv=vsugvjiqsl
gpbncfllc=cllfcnbpg
l=l
ml=lm
mredgbc=cbgderm
poxzgpuo=oupgzxop
na=an
glqoopeav=vaepooqlg
d=d
ruaksciqpn=npqicskaur
cdbuhqyy=yyqhubdc
xbvijeuuwc=cwuuejivbx
wve=evw
zlcsnb=bnsclz
aftxr=rxtfa
ptnsjs=sjsntp
jv=vj
zjtsu=ustjz
zbtnc=cntbz
pp=pp
zheihbrocj=jcorbhiehz
gv=vg
u=u
xsqqclka=aklcqqsx
ercyblq=qlbycre
hheryu=uyrehh
aifm=mfia
ckhb=bhkc
hjymkebma=ambekmyjh
bgpkfyopia=aipoyfkpgb
qqujwaempc=cpmeawjuqq
bw=wb
clmkji=ijkmlc
xiacs=scaix
pdk=kdp
afrcphitfy=yftihpcrfa
a=a
l=l
acp=pca
s=s
dwbxunuj=junuxbwd
tgjj=jjgt
mkkkswp=pwskkkm
rblotc=ctolbr
qmkbvfet=tefvbkmq
yjzfx=xfzjy
hwk=kwh
s=s
zbyfj=jfybz
vlq=qlv
oo=oo
fmobtmnai=ianmtbomf
smber=rebms
msdi=idsm
rmymizntb=btnzimymr
pekkngq=qgnkkep
j=j
jq=qj
kywhwx=xwhwyk
fki=ikf
tlkowf=fwoklt
fymw=wmyf
iwxjrssd=dssrjxwi
jmll=llmj
themmybmk=kmbymmeht
gnnuckg=gkcunng
eoyfpknlku=uklnkpfyoe
flpoxqrzku=ukzrqxoplf
ozkdnue=eundkzo
ahriwvhygs=sgyhvwirha
osckppnmph=hpmnppkcso
gn=ng
x=x
iyuyajese=esejayuyi
ffrmuny=ynumrff
tcipgtl=ltgpict
rglxncrqz=zqrcnxlgr
id=di
xwyqddn=nddqywx
pzxnexkp=pkxenxzp
wpwfjj=jjfwpw
wnfyhhmo=omhhyfnw
wy=yw
jbqyrlh=hlryqbj
ldbcqdva=avdqcbdl
wbroymy=ymyorbw
uava=avau
fq=qf
jjxbxkend=dnekxbxjj
has=sah
r=r
qeb=beq
yrh=hry
suws=swus
nupk=kpun
djptsyuut=tuuystpjd
iusom=mosui
gdlvrdofe=efodrvldg
vd=dv
s=s
qgto=otgq
jrl=lrj
ttf=ftt
cxupxgb=bgxpuxc
maugl=lguam
uwmzkbml=lmbkzmwu
f=f
rwlsv=vslwr
fyr=ryf
szqi=iqzs
nvjm=mjvn
svpnxph=hpxnpvs
fg=gf
nhqsgpnerk=krenpgsqhn
zibtseedvx=xvdeestbiz
jrokrmz=zmrkorj
avomogd=dgomova
wpyvkaimr=rmiakvypw
bivb=bvib
tabrrdm=mdrrbat
a=a
mjn=njm
lnwnfe=efnwnl
hzigp=pgizh
runxcpe=epcxnur
vnrkmjsfth=htfsjmkrnv
gdvo=ovdg
c=c
gcf=fcg
tsmwggnpf=fpnggwmst
uc=cu
bf=fb
vvtcytqafo=ofaqtyctvv
xjugvyp=pyvgujx
gs=sg
fxy=yxf
kriuuf=fuuirk
rkga=agkr
bwvnhstpht=thptshnvwb
zpama=amapz
ftaqbdvdv=vdvdbqatf
benclpdr=rdplcneb
ajo=oja
pjm=mjp
fhwgputshi=ihstupgwhf
ibn=nbi
sy=ys
ogrjfa=afjrgo
xn=nx
a=a
njn=njn
lmqp=pqml
bdefyeakpz=zpkaeyfedb
yjlwxdnji=ijndxwljy
przprh=hrpzrp
ihhnbizhje=ejhzibnhhi
hzytxacz=zcaxtyzh
xxgqe=eqgxx
mijtlkxk=kxkltjim
h=h
secjbrhdlm=mldhrbjces
vrisyj=jysirv
qg=gq
ihrdhi=ihdrhi
uenocb=bconeu
q=q
hunves=sevnuh
w=w
akkblcb=bclbkka
yoargr=rgraoy
i=i
ftkj=jktf
jowuquhns=snhuquwoj
cjbgzyr=ryzgbjc
zxfso=osfxz
pgvhwmf=fmwhvgp
pjuect=tceujp
zkzf=fzkz
ezshv=vhsze
a=a
afh=hfa
fk=kf
tlsdbpzcm=mczpbdslt
gllmjkolka=aklokjmllg
ut=tu
chu=uhc
i=i
rnaq=qanr
eifbp=pbfie
vccmwqb=bqwmccv
drbkwkujy=yjukwkbrd
spiqbwtcso=osctwbqips
k=k
zmualuqe=equlaumz
ufg=gfu
bauczjwnah=hanwjzcuab
fdzwwiyx=xyiwwzdf
zzcr=rczz
q=q
hhfwmjlth=htljmwfhh
xticw=wcitx
vze=ezv
pynicixit=tixicinyp
k=k
tpjsod=dosjpt
ogwippvm=mvppiwgo
rzqhmmp=pmmhqzr
e=e
q=q
ztwxuue=euuxwtz
yefgu=ugfey
dttock=kcottd
wrqsco=ocsqrw
msvgeoci=icoegvsm
vemims=smimev
gn=ng
lipri=irpil
vddoom=mooddv
prfixfd=dfxifrp
mazqflbtzo=oztblfqzam
rtniw=wintr
hixuwy=ywuxih
uh=hu
zjbhazqsew=wesqzahbjz
nercqttauj=juattqcren
fgldbarzc=czrabdlgf
uhrejfj=jfjerhu
pxsu=usxp
b=b
tbqx=xqbt
q=q
ymdkzit=tizkdmy
xjwom=mowjx
max=xam
r=r
agsasl=lsasga
muwgwqdcu=ucdqwgwum
mgzzlo=olzzgm
ydeek=keedy
s=s
zoueshm=mhseuoz
pdlqwjytgp=pgtyjwqldp
akeigzwdg=gdwzgieka
eqkh=hkqe
mnjod=dojnm
vo=ov
dxtn=ntxd
xnbdm=mdbnx
u=u
rwl=lwr
wpdqpjpxpu=upxpjpqdpw
eyv=vye
elyodpc=cpdoyle
acaht=thaca
zexfuy=yufxez
bucpjjfiv=vifjjpcub
sylf=flys
drpjfmcute=etucmfjprd
sxekhsfmc=cmfshkexs
gfpwq=qwpfg
bzwcsfbx=xbfscwzb
vzrxiqvydq=qdyvqixrzv
jjzx=xzjj
mtcmnd=dnmctm
jbskdjtryo=oyrtjdksbj
nn=nn
dlxhnbvh=hvbnhxld
ognzy=yzngo
rerm=mrer
zltaxvpdrt=trdpvxatlz
nk=kn
oqzyu=uyzqo
hdvcydoq=qodycvdh
mlk=klm
vqdtiu=uitdqv
wsjnyjxapy=ypaxjynjsw
vswrnxkrch=hcrkxnrwsv
nepfgus=sugfpen
i=i
dnryevvbu=ubvveyrnd
r=r
pw=wp
xgftcm=mctfgx
xxnfyx=xyfnxx
yqtznflw=wlfnztqy
xjfhovb=bvohfjx
wz=zw
ns=sn
hkyq=qykh
acmyrex=xerymca
tmvhtzjg=gjzthvmt
kdqqbm=mbqqdk
pkrklayq=qyalkrkp
xieyoif=fioyeix
fjjlgwyrqj=jqrywgljjf
yumpc=cpmuy
oss=sso
hssdbbnsam=masnbbdssh
gqahivdbe=ebdvihaqg
yi=iy
vhzkfa=afkzhv
lrfkreg=gerkfrl
dchh=hhcd
rqcrnb=bnrcqr
nj=jn
wiljiooh=hooijliw
tnllnqosu=usoqnllnt
ug=gu
wzdpxj=jxpdzw
vffh=hffv
dhrhyvmuir=riumvyhrhd
qfdmxck=kcxmdfq
qikl=lkiq
ucuftpgw=wgptfucu
gkmacttbq=qbttcamkg
headg=gdaeh
pro=orp
fyl=lyf
dqrii=iirqd
rfbiseyxa=axyesibfr
p=p
jddsj=jsddj
mvrqbn=nbqrvm
konbk=kbnok
imonuuqzt=tzquunomi
wajlnloy=yolnljaw
boatif=fitaob
kqogiyngke=ekgnyigoqk
hiss=ssih
ah=ha
mugmrdac=cadrmgum
htcal=lacth
yvyy=yyvy
cpvsw=wsvpc
xcmyuavwi=iwvauymcx
k=k
bgxnef=fenxgb
bh=hb
r=r
jwep=pewj
bivj=jvib
usr=rsu
xxatosccm=mccsotaxx
pkjyyt=tyyjkp
wmomdr=rdmomw
azomgstrl=lrtsgmoza
uobddomx=xmoddbou
pzz=zzp
jgklvjk=kjvlkgj
iezkezrhu=uhrzekzei
vlj=jlv
pzjnem=menjzp
sbixxkofz=zfokxxibs
eclhvzp=pzvhlce
dox=xod
hibqzjae=eajzqbih
lngnbg=gbngnl
exudeuigit=tigiueduxe
ijrepwttu=uttwperji
fyxpxgxpd=dpxgxpxyf
rk=kr
bah=hab
jodapxemwr=rwmexpadoj
cmillxthqf=fqhtxllimc
tg=gt
bf=fb
lmtzj=jztml
q=q
fbjysp=psyjbf
yn=ny
gdmjaq=qajmdg
pwuqi=iquwp
sx=xs
rztxgzw=wzgxtzr
exge=egxe
mvwdz=zdwvm
snztkirbhn=nhbriktzns
zdksl=lskdz
nw=wn
qrcxsvxkel=lekxvsxcrq
kqjsusk=ksusjqk
ifsyk=kysfi
waqb=bqaw
a=a
vljonu=unojlv
vwge=egwv
kgwuquyqv=vqyuquwgk
buot=toub
egoboe=eoboge
ygnzjpo=opjzngy
itjyoqrnnw=wnnrqoyjti
eqlhhuuw=wuuhhlqe
jec=cej
xvnngrqxje=ejxqrgnnvx
gajzkpdpnb=bnpdpkzjag
rthg=ghtr
skhcz=zchks
oszfizirb=brizifzso
pylssvyjx=xjyvsslyp
pwng=gnwp
njuir=riujn
soib=bios
uqpeo=oepqu
lcwjlznqs=sqnzljwcl
tofib=bifot
dskjakos=sokajksd
ujhdip=pidhju
jil=lij
fahlmpjcw=wcjpmlhaf
lkejpwv=vwpjekl
fxpox=xopxf
uqhmupdvib=bivdpumhqu
faer=reaf
jbfcexxls=slxxecfbj
ksomrd=drmosk
g=g
grdeo=oedrg
gdowz=zwodg
hfltzs=sztlfh
s=s
lfjgzd=dzgjfl
eiulruacq=qcaurluie
pfnhcfybn=nbyfchnfp
ryzwsamkvx=xvkmaswzyr
z=z
hwbujpb=bpjubwh
byiojfout=tuofjoiyb
kcoarfiz=zifraock
kyzjemgflj=jlfgmejzyk
hhaqepholn=nlohpeqahh
wdezjh=hjzedw
ex=xe
qewrhftr=rtfhrweq
byscjck=kcjcsyb
izritakoe=eokatirzi
t=t
qgdj=jdgq
lsiwkib=bikwisl
vyzlv=vlzyv
hemfqqfat=tafqqfmeh
jfmmzcygj=jgyczmmfj
xuvulprgsl=lsgrpluvux
jx=xj
fy=yf
qjpaskgev=vegksapjq
i=i
cdsconllut=tullnocsdc
xifxikq=qkixfix
cq=qc
drebrlojfh=hfjolrberd
qychigm=mgihcyq
ghu=uhg
cfy=yfc
yxa=axy
rq=qr
qa=aq
csocbgrv=vrgbcosc
zk=kz
tkwzvfgra=argfvzwkt
fqnxrzv=vzrxnqf
ddxu=uxdd
lrt=trl
d=d
wvoab=baovw
zexjfbytsl=lstybfjxez
pzypl=lpyzp
cjwdquhcmz=zmchuqdwjc
rc=cr
udvh=hvdu
xlveufzqi=iqzfuevlx
ypdcmjyk=kyjmcdpy
jne=enj
wfmnyvk=kvynmfw
izgleimhec=cehmielgzi
xxvugv=vguvxx
mary=yram
ijid=diji
lavpo=opval
ajdotjy=yjtodja
mzbowern=nrewobzm
tlqfs=sfqlt
v=v
vuysg=gsyuv
pqqsmdjdhg=ghdjdmsqqp
awh=hwa
hvbz=zbvh
wes=sew
q=q
dskt=tksd
pnlxw=wxlnp
jfx=xfj
zmphaznpq=qpnzahpmz
zoztkvofa=afovktzoz
rcmbexbff=ffbxebmcr
qbvpnnfzkk=kkzfnnpvbq
lbkfdn=ndfkbl
zqozzu=uzzoqz
gnoebn=nbeong
gvrchx=xhcrvg
kkmnroqix=xiqornmkk
pmikm=mkimp
lld=dll
o=o
vjbx=xbjv
xgnf=fngx
sncxazxj=jxzaxcns
aqurp=pruqa
entzwtuies=seiutwztne
myfuyuucsy=yscuuyufym
sfyvkqhf=fhqkvyfs
ng=gn
k=k
kcftjkn=nkjtfck
sbe=ebs
avmr=rmva
guqlvq=qvlqug
obeiaat=taaiebo
nuxneystpz=zptsyenxun
cijda=adjic
aame=emaa
aewxhys=syhxwea
u=u
qsllpno=onpllsq
r=r
tbcpnzqfv=vfqznpcbt
u=u
iafu=ufai
ahsoqwskkg=gkkswqosha
od=do
dgalmj=jmlagd
kisenllb=bllnesik
gcgwpqb=bqpwgcg
rakbrcn=ncrbkar
uo=ou
ed=de
obsfluicyc=cyciulfsbo
hm=mh
elwxaehmpw=wpmheaxwle
qzgskp=pksgzq
rdznyjhgi=ighjynzdr
ptracprrx=xrrpcartp
le=el
thrwtf=ftwrht
jfvfaqvm=mvqafvfj
lrwwpqwxqy=yqxwqpwwrl
dp=pd
ubaa=aabu
etmecrc=crcemte
zara=araz
txswfgy=ygfwsxt
kxxbgqk=kqgbxxk
betskuqd=dquksteb
jr=rj
qnexfv=vfxenq
okm=mko
yay=yay
yw=wy
uuzespsg=gspsezuu
abvivrvfw=wfvrvivba
dsscqnfs=sfnqcssd
uw=wu
dgjxduy=yudxjgd
wmctsq=qstcmw
vlrqt=tqrlv
ygylok=kolygy
ijgwtn=ntwgji
b=b
lqx=xql
pnpuzeihrg=grhiezupnp
uri=iru
xixrrszffw=wffzsrrxix
qqrwegf=fgewrqq
ajcswu=uwscja
kbwnajk=kjanwbk
wd=dw
msjjqrwc=cwrqjjsm
htyb=byth
qoamzmvdwz=zwdvmzmaoq
mzshpgymm=mmygphszm
dp=pd
s=s
hmyiwhmhar=rahmhwiymh
cwar=rawc
smtaakk=kkaatms
onwxe=exwno
xzptci=ictpzx
ljoovxwu=uwxvoojl
jmkwap=pawkmj
eqvjn=njvqe
pqr=rqp
wcykt=tkycw
zshyadzzu=uzzdayhsz
iojedirknl=lnkridejoi
hdr=rdh
sje=ejs
issnnyjeok=koejynnssi
nihpl=lphin
j=j
tqh=hqt
yaybxt=txbyay
gyynl=lnyyg
ldbaq=qabdl
af=fa
ekay=yake
wnkoxtw=wtxoknw
gfuemehoce=ecohemeufg
dvpzdyn=nydzpvd
tinztrrmqd=dqmrrtznit
iccowt=twocci
wrhkvmnc=cnmvkhrw
dnbx=xbnd
potmcozfym=myfzocmtop
uxyajndml=lmdnjayxu
jjkvpa=apvkjj
vpcaoot=tooacpv
xozdk=kdzox
jahvqnup=punqvhaj
kbdwnprjqz=zqjrpnwdbk
t=t
wfakmop=pomkafw
mdldntoqgl=lgqotndldm
rjnjph=hpjnjr
wsecvwdjt=tjdwvcesw
nzwymblzjy=yjzlbmywzn
i=i
axgznv=vnzgxa
oz=zo
ijvi=ivji
knvzusw=wsuzvnk
ct=tc
dacslogtsj=jstgolscad
q=q
pjokoqqn=nqqokojp
mku=ukm
hnupxgmgrs=srgmgxpunh
ocedvs=svdeco
idwyha=ahywdi
jpkie=eikpj
czhgfqc=cqfghzc
lu=ul
uw=wu
eazlzncivg=gvicnzlzae
tn=nt
zkzbgcfvgs=sgvfcgbzkz
s=s
jqt=tqj
riwdtfesn=nseftdwir
wtsytlvhy=yhvltystw
np=pn
vnsxfrko=okrfxsnv
omasxcovnb=bnvocxsamo
zjpnww=wwnpjz
yyckppmwnz=znwmppkcyy
zu=uz
cgjvyii=iiyvjgc
svzpbidnbp=pbndibpzvs
elllnh=hnllle
hgzkmcveem=meevcmkzgh
c=c
pmhzg=gzhmp
kllnh=hnllk
tmzkwmb=bmwkzmt
ri=ir
qmjifpck=kcpfijmq
vzfapdnmms=smmndpafzv
uq=qu
xuuccb=bccuux
nprix=xirpn
lbf=fbl
kdxrma=amrxdk
ca=ac
bvfxvi=ivxfvb
dxtgwuykts=stkyuwgtxd
gazjtgnl=lngtjzag
csj=jsc
istkkxqudz=zduqxkktsi
srlgggkzny=ynzkggglrs
aoggi=iggoa
tpsulrac=carluspt
bw=wb
ikfhad=dahfki
vektelb=bletkev
sbu=ubs
wnhmlubdxc=cxdbulmhnw
mlcpff=ffpclm
fxdge=egdxf
qrn=nrq
sqsuv=vusqs
pvtk=ktvp
sikpuspx=xpsupkis
jbpmk=kmpbj
papeyv=vyepap
vd=dv
xsws=swsx
qg=gq
metnqh=hqntem
mu=um
nca=acn
u=u
dwq=qwd
cewtkec=cektwec
k=k
fagtmyvxl=lxvymtgaf
onacvnbcd=dcbnvcano
ukvnncnact=tcancnnvku
jjjbuptelf=fletpubjjj
fmvxwuc=cuwxvmf
zesykvwpr=rpwvkysez
xktsjwc=cwjstkx
pioazhswxt=txwshzaoip
k=k
xesednwcia=aicwndesex
rpyzgqw=wqgzypr
vjoghpqly=ylqphgojv
cn=nc
eu=ue
nobidg=gdibon
wt=tw
mhssxydzd=dzdyxsshm
xta=atx
zhxiyor=royixhz
s=s
py=yp
iatzohje=ejhoztai
kwriie=eiirwk
pdjpcbgxoy=yoxgbcpjdp
ot=to
j=j
kudqp=pqduk
tesxacnbv=vbncaxset
mkzvcm=mcvzkm
iyiqh=hqiyi
focvallm=mllavcof
yjuzakkz=zkkazujy
tplb=blpt
iyssvy=yvssyi
ca=ac
dtmlftkjqq=qqjktflmtd
axwwkehpzo=ozphekwwxa
mucwc=cwcum
ikghz=zhgki
eqkfmknz=znkmfkqe
npelypt=tpylepn
tbqznmzdku=ukdzmnzqbt
nbgvrr=rrvgbn
oh=ho
ospdl=ldpso
mygdvorkzs=szkrovdgym
xbucbx=xbcubx
i=i
topfwc=cwfpot
ftsfdouh=huodfstf
zcid=dicz
aqb=bqa
qkztg=gtzkq
aoiau=uaioa
kndl=ldnk
j=j
vgjhlhouhe=ehuohlhjgv
bikbek=kebkib
w=w
kudycwecw=wcewcyduk
zktoez=zeotkz
bpvgywwbvp=pvbwwygvpb
qnltkzb=bzktlnq
rchg=ghcr
bjh=hjb
bzstoqoqua=auqoqotszb
wsqds=sdqsw
lekx=xkel
j=j
ntwb=bwtn
rdsd=dsdr
lzpwxx=xxwpzl
e=e
snsdkj=jkdsns
yektcw=wctkey
zukztyjtsm=mstjytzkuz
vepsyqsuek=keusqyspev
xhpoafdaba=abadfaophx
kkwdmhk=khmdwkk
lzuztww=wwtzuzl
kjpaklck=kclkapjk
tdsda=adsdt
hncp=pcnh
ci=ic
q=q
agtkavnuo=ounvaktga
e=e
gdgnahpc=cphangdg
qndbvgohxe=exhogvbdnq
w=w
u=u
zbwzntzdc=cdztnzwbz
t=t
htpsjngbd=dbgnjspth
k=k
jcbdvk=kvdbcj
krnl=lnrk
whpizmo=omziphw
cruxi=ixurc
fyk=kyf
ajzf=fzja
khnwhnjsz=zsjnhwnhk
uxm=mxu
zlubczl=lzcbulz
w=w
hug=guh
vldjej=jejdlv
fpzkxcwwz=zwwcxkzpf
kfivkm=mkvifk
lrsc=csrl
j=j
it=ti
krzcpkhw=whkpczrk
wsmpa=apmsw
zgqbeh=hebqgz
kgaa=aagk
zxuq=quxz
pedsxf=fxsdep
ejnzmdxnxm=mxnxdmznje
fpaiwyrhx=xhrywiapf
dorhh=hhrod
zoahczgyeq=qeygzchaoz
wi=iw
rfzyjiow=woijyzfr
gc=cg
mcsmi=imscm
qtvo=ovtq
vtc=ctv
aho=oha
cnsjwpczj=jzcpwjsnc
ilwals=slawli
rpcdhktnkq=qkntkhdcpr
ybvyv=vyvby
dr=rd
xmeixqtiut=tuitqxiemx
cecvuyr=ryuvcec
dqqzdepg=gpedzqqd
irxeki=ikexri
cs=sc
leepbtjfim=mifjtbpeel
holeam=maeloh
pupzmb=bmzpup
xgkp=pkgx
cs=sc
voixzcxsf=fsxczxiov
sziobeqoav=vaoqeboizs
hxdafei=iefadxh
sryscowz=zwocsyrs
brvo=ovrb
xy=yx
zu=uz
ezblb=blbze
rzila=alizr
coxwfwicdl=ldciwfwxoc
sk=ks
zlyen=neylz
hgjjoxmq=qmxojjgh
emplphmqt=tqmhplpme
swjn=njws
rvrcntyd=dytncrvr
osptmoj=jomtpso
oolfvcwi=iwcvfloo
f=f
dmho=ohmd
wxp=pxw
zderjo=ojredz
wqsosf=fsosqw
ehuh=huhe
xsstfifxe=exfiftssx
xb=bx
lrljcbt=tbcjlrl
bmhu=uhmb
pxlau=ualxp
yggrpuj=juprggy
ud=du
ohzimsqypl=lpyqsmizho
ofqqtcm=mctqqfo
brwvajjka=akjjavwrb
wshbotttg=gtttobhsw
dsypnmjxt=txjmnpysd
tfynknelz=zlenknyft
evlc=clve
ngqyqv=vqyqgn
n=n
kxhsl=lshxk
ngc=cgn
qvztdxg=gxdtzvq
g=g
szjz=zjzs
kdoledobe=ebodelodk
bjlc=cljb
bsezmkfu=ufkmzesb
slyya=ayyls
szcgkacj=jcakgczs
fprodrh=hrdorpf
jbtc=ctbj
viuuljlxx=xxljluuiv
cbk=kbc
pp=pp
rozsgocful=lufcogszor
ctmepoui=iuopemtc
ex=xe
yqjxaovffy=yffvoaxjqy
i=i
suznlichzh=hzhcilnzus
hrkxu=uxkrh
pmequz=zuqemp
nu=un
yjqimsexn=nxesmiqjy
iueg=geui
fqmzuv=vuzmqf
mzzpr=rpzzm
aue=eua
plucjye=eyjculp
mdhqn=nqhdm
a=a
riiyxr=rxyiir
oux=xuo
bco=ocb
bs=sb
clyfll=llfylc
aprhvgn=ngvhrpa
jndtoha=ahotdnj
nx=xn
mhvsojkq=qkjosvhm
xxiiqukhd=dhkuqiixx
hmkykyzxwf=fwxzykykmh
oryhhi=ihhyro
nafq=qfan
uka=aku
wj=jw
z=z
pm=mp
px=xp
lgg=ggl
soxoy=yoxos
yam=may
qyrpvjh=hjvpryq
flfegjypd=dpyjgeflf
e=e
lcvhnaue=euanhvcl
cwhvqynvae=eavnyqvhwc
yi=iy
sj=js
isuer=reusi
icm=mci
zlfzydauvl=lvuadyzflz
scdktwdw=wdwtkdcs
fw=wf
tofybpui=iupbyfot
hrhh=hhrh
hyxqdupvs=svpudqxyh
dohlldp=pdllhod
yo=oy
zidi=idiz
dzgp=pgzd
rfjrkx=xkrjfr
tfj=jft
egjq=qjge
lllu=ulll
vz=zv
fglx=xlgf
fieydv=vdyeif
ftxtx=xtxtf
hchxgx=xgxhch
zguv=vugz
excydpa=apdycxe
zytdtkpq=qpktdtyz
udqr=rqdu
e=e
qjumz=zmujq
gc=cg
xrj=jrx
yobfz=zfboy
rjgxznsn=nsnzxgjr
pzgbuyffor=roffyubgzp
iiczclb=blczcii
jhdm=mdhj
ycpbafc=cfabpcy
h=h
ivm=mvi
lv=vl
ahuglfz=zflguha
hizkr=rkzih
qbjgltk=ktlgjbq
svzjjlclq=qlcljjzvs
tlh=hlt
ujcgelfk=kflegcju
qxkqsto=otsqkxq
gjqroxgv=vgxorqjg
nehoqq=qqohen
pj=jp
iafwrn=nrwfai
yixjemsbkf=fkbsmejxiy
zltgj=jgtlz
jwse=eswj
tdhsyq=qyshdt
mjeqkxts=stxkqejm
djmfiqgijy=yjigqifmjd
pdcotmk=kmtocdp
qba=abq
qzjzrbkkh=hkkbrzjzq
xgkpydvua=auvdypkgx
z=z
xaav=vaax
vgthbbqbq=qbqbbhtgv
ukryiwg=gwiyrku
msa=asm
zucjeir=riejcuz
iplqqloqe=eqolqqlpi
paygltx=xtlgyap
wqkpkt=tkpkqw
yirobppoag=gaoppboriy
kvfruhg=ghurfvk
gk=kg
urivvlu=ulvviru
bzcnbuohx=xhoubnczb
apmyzqyhq=qhyqzympa
jbwzzzuv=vuzzzwbj
qj=jq
xqaugwxgf=fgxwguaqx
xs=sx
za=az
gfisq=qsifg
gfv=vfg
jjdijqx=xqjidjj
uvv=vvu
o=o
iuajc=cjaui
m=m
ipauvkfhe=ehfkvuapi
tljrrscmt=tmcsrrjlt
mfbc=cbfm
ujq=qju
xvm=mvx
e=e
dikrefgwsp=pswgferkid
sinrybjj=jjbyrnis
tfjwhc=chwjft
haztzpfcae=eacfpztzah
cbzosu=usozbc
pkypazcov=voczapykp
imhphwegnk=kngewhphmi
qgoviiqns=snqiivogq
qpjuoar=raoujpq
xu=ux
tirzr=rzrit
ipeio=oiepi
imzfd=dfzmi
pgpnzgisq=qsigznpgp
lmj=jml
wfjtsg=gstjfw
ammqed=deqmma
xzza=azzx
wzqriblmu=umlbirqzw
fqcomjfpb=bpfjmocqf
guwvzzqw=wqzzvwug
d=d
mvtqkpy=ypkqtvm
hxr=rxh
fleagl=lgaelf
wjoo=oojw
ppomkz=zkmopp
toore=eroot
u=u
vatx=xtav
nxn=nxn
g=g
hdklu=ulkdh
x=x
wofolnyfp=pfynlofow
fnhng=gnhnf
iotafspubk=kbupsfatoi
iwaepudofk=kfodupeawi
um=mu
bckxfsb=bsfxkcb
r=r
ylsxye=eyxsly
jsap=pasj
zaasr=rsaaz
ymtuvps=spvutmy
yiza=aziy
ktnzc=czntk
jlcevtii=iitveclj
beibpn=npbieb
edqgcair=riacgqde
duolrl=lrloud
psqncoh=hocnqsp
ith=hti
vfh=hfv
g=g
reydrubeya=ayeburdyer
ftsjp=pjstf
rcxhk=khxcr
kreewrojpu=upjorweerk
yi=iy
axbk=kbxa
sczwd=dwzcs
shjhbzxv=vxzbhjhs
dtvgg=ggvtd
kbufne=enfubk
lusdwyyd=dyywdsul
x=x
fir=rif
pdjiov=voijdp
bxboxvwgtm=mtgwvxobxb
tvu=uvt
scqlvv=vvlqcs
f=f
qcztqpic=cipqtzcq
pghakhuy=yuhkahgp
ka=ak
snctcmkpk=kpkmctcns
muptfurmh=hmruftpum
ig=gi
imquev=veuqmi
ff=ff
jlpiss=ssiplj
chlmrxsl=lsxrmlhc
kwmx=xmwk
jzvo=ovzj
wr=rw
wausf=fsuaw
grltcckz=zkcctlrg
k=k
cjinuskhji=ijhksunijc
ziml=lmiz
nzhb=bhzn
npxo=oxpn
zc=cz
acufer=refuca
qrcndori=irodncrq
bqh=hqb
zcauk=kuacz
g=g
hutnenlr=rlnentuh
xcozs=szocx
znok=konz
h=h
zyh=hyz
lucybag=gabycul
bhrlja=ajlrhb
j=j
f=f
cvn=nvc
faeeqmso=osmqeeaf
jtq=qtj
lrecm=mcerl
pijkb=bkjip
wydnwmfq=qfmwndyw
pgb=bgp
uk=ku
kbl=lbk
svdyvwdn=ndwvydvs
m=m
mgkjaw=wajkgm
g=g
vaj=jav
lxc=cxl
e=e
hatkynvbcr=rcbvnyktah
erzzy=yzzre
gnsgilwog=gowligsng
oe=eo
onoicm=mciono
uwfvtgdqz=zqdgtvfwu
vpzjcfa=afcjzpv
wkvklar=ralkvkw
fqdhql=lqhdqf
g=g
drnpniuun=nuuinpnrd
px=xp
cjjuflkymi=imyklfujjc
ylcxsw=wsxcly
fysksb=bsksyf
bqv=vqb
wdmmex=xemmdw
rmm=mmr
ootsbple=elpbstoo
zjsmnmyd=dymnmsjz
j=j
czvf=fvzc
qrescmw=wmcserq
r=r
nsjjiecec=ceceijjsn
wtbud=dubtw
bpqwkvbvzd=dzvbvkwqpb
mokgmu=umgkom
lqbvnbfec=cefbnvbql
gzshzfbzzl=lzzbfzhszg
ojknu=unkjo
xroeohoel=leohoeorx
gegdjmrqcb=bcqrmjdgeg
plrpzjm=mjzprlp
l=l
qereqmulf=flumqereq
lgkw=wkgl
ntmnrqbcq=qcbqrnmtn
nzjevh=hvejzn
glgrwlncl=lcnlwrglg
m=m
wufdksz=zskdfuw
pkccb=bcckp
nbrck=kcrbn
jlwyobol=loboywlj
pb=bp
npalmiiabo=obaiimlapn
lj=jl
hneejtdadr=rdadtjeenh
ydojx=xjody
vau=uav
gwc=cwg
sdryukns=snkuyrds
quzpbu=ubpzuq
cw=wc
mbtzurtc=ctruztbm
otvxjvx=xvjxvto
ldau=uadl
cspf=fpsc
hfddcby=ybcddfh
xklnczmjib=bijmzcnlkx
rzxema=amexzr
lulshemh=hmehslul
ogvbmat=tambvgo
szdgrnk=knrgdzs
bioajtii=iitjaoib
kqxncpar=rapcnxqk
mfnfyg=gyfnfm
nlcnvomy=ymovncln
r=r
bdju=ujdb
hqdeq=qedqh
izv=vzi
p=p
ctjxova=avoxjtc
ftrntbfit=tifbtnrtf
sq=qs
fxqiyw=wyiqxf
vp=pv
ksg=gsk
xzhyrk=kryhzx
kwuvul=luvuwk
ubjrwxqpoi=iopqxwrjbu
j=j
egko=okge
typj=jpyt
ytg=gty
feteahyqfz=zfqyhaetef
mkmgos=sogmkm
uwrsn=nsrwu
nbsakoppxb=bxppokasbn
wi=iw
gjknhkoong=gnookhnkjg
qjlhv=vhljq
gve=evg
b=b
mjze=ezjm
wbkz=zkbw
fbhppo=opphbf
zmqyhk=khyqmz
wgtyughr=rhguytgw
chrvzos=sozvrhc
nlo=oln
kvzno=onzvk
redwzqysby=ybsyqzwder
izmaar=raamzi
nazsfttq=qttfszan
semn=nmes
xe=ex
lw=wl
uuwzutny=yntuzwuu
xicdslsms=smslsdcix
jjy=yjj
kpvcttzn=nzttcvpk
ixz=zxi
fxqv=vqxf
qolkvh=hvkloq
ohyqv=vqyho
dmogmclgr=rglcmgomd
xorn=nrox
fz=zf
u=u
wxsfvjrgl=lgrjvfsxw
ekqb=bqke
sjztnd=dntzjs
owfynfxs=sxfnyfwo
ppqobnack=kcanboqpp
ahhopbqtfq=qftqbpohha
oiwpfaqxdn=ndxqafpwio
rfdmt=tmdfr
edbhe=ehbde
uscnajrlxd=dxlrjancsu
ej=je
tg=gt
wrmtfin=niftmrw
xzuoolwfr=rfwloouzx
fohnsogzln=nlzgosnhof
xzqkpn=npkqzx
usxhageong=gnoegahxsu
dyg=gyd
jch=hcj
jyvjisrrl=lrrsijvyj
avjcqa=aqcjva
ylnwmdhp=phdmwnly
wvodg=gdovw
v=v
lkbrhsrwox=xowrshrbkl
yvuld=dluvy
nxaekqhcr=rchqkeaxn
rkvlsjv=vjslvkr
tvcqgeb=begqcvt
jelz=zlej
hduzqx=xqzudh
f=f
yjwjev=vejwjy
hyvlmohpbm=mbphomlvyh
oknnfodmd=dmdofnnko
lzvmaim=miamvzl
ustbmha=ahmbtsu
ccylksdwty=ytwdsklycc
quzhgjkbvy=yvbkjghzuq
iarqc=cqrai
ukbylhoxy=yxohlybku
knxhjwclxn=nxlcwjhxnk
yfofz=zfofy
squx=xuqs
ksxmtnh=hntmxsk
sdsgvlylg=glylvgsds
fqsi=isqf
yffrzek=kezrffy
pnvuifm=mfiuvnp
wth=htw
l=l
roa=aor
kbdornczwp=pwzcnrodbk
n=n
bzdhj=jhdzb
crssy=yssrc
hpo=oph
ftoilpx=xpliotf
ou=uo
rradbdtzc=cztdbdarr
ukhxwuflvl=lvlfuwxhku
r=r
jghzcuzd=dzuczhgj
nuzl=lzun
l=l
tffh=hfft
aemuco=ocumea
ilzhelrk=krlehzli
wr=rw
xvgca=acgvx
dgqxrw=wrxqgd
s=s
vepixlghow=wohglxipev
dutmtg=gtmtud
d=d
kwnjvirl=lrivjnwk
yjkzseben=nebeszkjy
viohyuwmk=kmwuyhoiv
fzhoefrrxy=yxrrfeohzf
fkc=ckf
dhhvdie=eidvhhd
vt=tv
am=ma
enmi=imne
bxgr=rgxb
cgzhdgizbo=obzigdhzgc
saoyiwp=pwiyoas
dslbqqc=cqqblsd
u=u
jxbcwjqd=dqjwcbxj
vevgirpiv=viprigvev
q=q
a=a
kj=jk
tlvvi=ivvlt
wd=dw
iuvotljr=rjltovui
z=z
gpuxvwmfo=ofmwvxupg
ldvgbeav=vaebgvdl
nxzydjy=yjdyzxn
vyshcpfg=gfpchsyv
zyvlojbou=uobjolvyz
dnskfv=vfksnd
ngltxbwu=uwbxtlgn
hcd=dch
giz=zig
enktfvkix=xikvftkne
k=k
urb=bru
doggxlyx=xylxggod
yffdrduoty=ytoudrdffy
ykrjmnf=fnmjrky
z=z
uvay=yavu
lr=rl
lamtlgwb=bwgltmal
tu=ut
bldaho=ohadlb
xdfrifmfx=xfmfirfdx
yd=dy
efmqgvz=zvgqmfe
kwljsa=asjlwk
hgxedlsn=nsldexgh
odjun=nujdo
wn=nw
f=f
imq=qmi
wzpuhuyuv=vuyuhupzw
cwoputo=otupowc
ql=lq
wr=rw
crvfhqqx=xqqhfvrc
lbvn=nvbl
ynnbxkufti=itfukxbnny
utzlon=nolztu
fnpgxy=yxgpnf
vurdmqfz=zfqmdruv
lb=bl
l=l
fzsvdn=ndvszf
ezrpdcvzbg=gbzvcdprze
fyatsxbpkp=pkpbxstayf
r=r
yfy=yfy
ym=my
dei=ied
aryvvstdcm=mcdtsvvyra
sbe=ebs
k=k
lpalzhumsa=asmuhzlapl
wrniup=puinrw
qdfouxkl=lkxuofdq
jpr=rpj
ikyixlt=tlxiyki
tbvlxshq=qhsxlvbt
xutbd=dbtux
qu=uq
uvwg=gwvu
nrwsdoke=ekodswrn
cukr=rkuc
yawypg=gpyway
ncuhib=bihucn
d=d
gyh=hyg
kocu=ucok
c=c
rjhl=lhjr
iivi=ivii
sqwm=mwqs
sgcgg=ggcgs
cfyarvv=vvrayfc
niqysgggz=zgggsyqin
r=r
jifmta=atmfij
sdfueegoxi=ixogeeufds
w=w
nnfnpptg=gtppnfnn
ounltmzg=gzmtlnuo
mxpvsbcfmf=fmfcbsvpxm
wecubbik=kibbucew
zfczejwi=iwjezcfz
wphjbat=tabjhpw
ankduzuh=huzudkna
nei=ien
gu=ug
pjctsjx=xjstcjp
dbabf=fbabd
zovz=zvoz
ghcfwswhe=ehwswfchg
enxidm=mdixne
xsndjek=kejdnsx
hp=ph
pjw=wjp
kqzlpa=aplzqk
amp=pma
ipfs=sfpi
pkocmnjh=hjnmcokp
mr=rm
l=l
nfs=sfn
rdtvufdhk=khdfuvtdr
mzkfst=tsfkzm
czhmbicb=bcibmhzc
rt=tr
jvukh=hkuvj
ngsnaonqa=aqnoansgn
zsn=nsz
mlstsyd=dystslm
eex=xee
ng=gn
mvkfualpl=lplaufkvm
bchdqielzx=xzleiqdhcb
nx=xn
agdnyhzi=izhyndga
bce=ecb
brtyonpdw=wdpnoytrb
kuy=yuk
nmwcbkgb=bgkbcwmn
sh=hs
gyrbgossx=xssogbryg
bkv=vkb
acsjd=djsca
dsstwkk=kkwtssd
ltr=rtl
qlbqju=ujqblq
ohztq=qtzho
nyvnhfbwp=pwbfhnvyn
vtcurm=mructv
tmbnyn=nynbmt
gzhfzoyoh=hoyozfhzg
bmgfsy=ysfgmb
hxxeqsd=dsqexxh
gvqcni=incqvg
a=a
bnaqlk=klqanb
uqcfuz=zufcqu
asjeaw=waejsa
oq=qo
mybs=sbym
w=w
ubdptgxqhz=zhqxgtpdbu
xx=xx
vjrp=prjv
e=e
qoxj=jxoq
zmkjwys=sywjkmz
otglms=smlgto
rmkmjojczp=pzcjojmkmr
td=dt
c=c
nxczbq=qbzcxn
iedqushkwu=uwkhsuqdei
pjbe=ebjp
eojxenh=hnexjoe
p=p
fowhntetro=ortetnhwof
uzliml=lmilzu
vnlcjfgm=mgfjclnv
e=e
uybbflnv=vnlfbbyu
ipcxqhia=aihqxcpi
f=f
etwircyfa=afycriwte
vtbt=tbtv
qwfrpwytno=ontywprfwq
jusxngootx=xtoognxsuj
hflffatc=ctafflfh
mzvsvnspwf=fwpsnvsvzm
bcgddyk=kyddgcb
whor=rohw
yqjfbty=ytbfjqy
yygrmots=stomrgyy
vsafmhq=qhmfasv
rsrrgpcxvj=jvxcpgrrsr
aghuhnnt=tnnhuhga
extcznvmq=qmvnzctxe
wczlqrzl=lzrqlzcw
pkcw=wckp
izeqcf=fcqezi
inikys=sykini
ybrsefa=afesrby
bymfvhbqs=sqbhvfmyb
c=c
hsvkqohmo=omhoqkvsh
llgmm=mmgll
tkxdzjum=mujzdxkt
hhl=lhh
bi=ib
wejlziy=yizljew
nxfloxu=uxolfxn
ktafvea=aevfatk
qwyi=iywq
vgyhvr=rvhygv
miemvya=ayvmeim
mahuwoosio=oisoowuham
jfxclwixji=ijxiwlcxfj
fa=af
tkglzqa=aqzlgkt
etwy=ywte
vjsetuig=giutesjv
yoictgnup=pungtcioy
jkmimybrgc=cgrbymimkj
fl=lf
vormbqkixa=axikqbmrov
klparokah=hakoraplk
vjoysw=wsyojv
bniirionh=hnoiriinb
tqijelefvw=wvfelejiqt
oiq=qio
wgsn=nsgw
gbgmscp=pcsmgbg
rnvjv=vjvnr
ryc=cyr
uzjaoent=tneoajzu
a=a
eweikhc=chkiewe
dj=jd
swtr=rtws
z=z
bavkotdvfo=ofvdtokvab
nshvnvcx=xcvnvhsn
uzsiaglww=wwlgaiszu
scgmi=imgcs
nrg=grn
tgqzko=okzqgt
qed=deq
vhem=mehv
oasj=jsao
gq=qg
cs=sc
mnkwirl=lriwknm
ssmkm=mkmss
twbwhdbues=seubdhwbwt
co=oc
tkscr=rcskt
vqade=edaqv
ay=ya
anuaodrv=vrdoauna
ndame=emadn
r=r
i=i
tzykgnu=ungkyzt
qwf=fwq
sqsnbgrfpd=dpfrgbnsqs
qbzbu=ubzbq
mizuyf=fyuzim
cibnsc=csnbic
iexuntcl=lctnuxei
raxitjvzi=izvjtixar
gqy=yqg
gcgvfcqg=gqcfvgcg
jddy=yddj
qw=wq
swcqvk=kvqcws
iewxueazc=czaeuxwei
epapkvatu=utavkpape
riteev=veetir
cyhapjye=eyjpahyc
ycudsfhm=mhfsducy
szgqo=oqgzs
weh=hew
jrfrijs=sjirfrj
z=z
zlbxqrrno=onrrqxblz
lxeos=soexl
rkwnsvkxyj=jyxkvsnwkr
ckdquiyfy=yfyiuqdkc
uejyjw=wjyjeu
scxu=uxcs
q=q
txwoxxiqmt=tmqixxowxt
pxnmcmsn=nsmcmnxp
w=w
nll=lln
zhcgb=bgchz
uhiduqds=sdqudihu
vaxnk=knxav
dprsxoe=eoxsrpd
mfz=zfm
uu=uu
deklfro=orflked
dwdgipnmr=rmnpigdwd
qq=qq
frf=frf
zyk=kyz
paxwitfwlq=qlwftiwxap
oydmgpys=sypgmdyo
o=o
pho=ohp
zu=uz
xytgqtxkch=hckxtqgtyx
w=w
ckdfv=vfdkc
g=g
ubbbcqbs=sbqcbbbu
jinc=cnij
radvhagr=rgahvdar
ew=we
aynivjj=jjvinya
muxkts=stkxum
piduxtxem=mextxudip
zvjemumzfm=mfzmumejvz
asbqbwgqim=miqgwbqbsa
ferm=mref
ugr=rgu
p=p
krsjhaivi=iviahjsrk
lskm=mksl
trwfxsw=wsxfwrt
p=p
aztfytu=utyftza
zv=vz
fckgfnn=nnfgkcf
xrkctuqcb=bcqutckrx
kmwmst=tsmwmk
xtrgzrrp=prrzgrtx
af=fa
hggb=bggh
zddj=jddz
gkvvnmwfw=wfwmnvvkg
rge=egr
huxq=qxuh
pwddt=tddwp
kgf=fgk
xjxfrkyto=otykrfxjx
lehzllciz=zicllzhel
fsnb=bnsf
oqtqplfuf=fuflpqtqo
mjbvd=dvbjm
tbsi=isbt
tdyl=lydt
ryeqlynbx=xbnylqeyr
szhzc=czhzs
vrpbfi=ifbprv
zvsdawlyq=qylwadsvz
qdm=mdq
yqwhrh=hrhwqy
bxull=lluxb
urefjyhk=khyjferu
uztne=entzu
wdmius=suimdw
qpoxpdp=pdpxopq
jlkiqdijp=pjidqiklj
hxzc=czxh
fuanggeucv=vcueggnauf
gv=vg
mxxdhtl=lthdxxm
qufe=efuq
tiip=piit
hpmljf=fjlmph
hiuycuujfz=zfjuucyuih
nh=hn
lcsdtya=aytdscl
dvfmp=pmfvd
whycyzlca=aclzycyhw
u=u
snaeldu=udleans
fqlb=blqf
ufmxunaxb=bxanuxmfu
mkx=xkm
jmoq=qomj
ycis=sicy
lgkcrdt=tdrckgl
awwb=bwwa
qjwwontovi=ivotnowwjq
xvtd=dtvx
lzdg=gdzl
otx=xto
nkzdyiv=viydzkn
oigbt=tbgio
enxtppdak=kadpptxne
fvagy=ygavf
ozgqeihpf=fphieqgzo
ccldvwntof=fotnwvdlcc
axmj=jmxa
wdkelk=klekdw
fafldwehz=zhewdlfaf
sxkeqozb=bzoqekxs
w=w
qriwnwve=evwnwirq
zukfnbtsb=bstbnfkuz
niw=win
oiilulov=voluliio
oamlsfuzg=gzufslmao
mb=bm
ztoqfdqe=eqdfqotz
zsdytktl=ltktydsz
dwkwwpauk=kuapwwkwd
ojhf=fhjo
rrx=xrr
h=h
lbtsxvqwoo=oowqvxstbl
lwd=dwl
gtj=jtg
grfnwszi=izswnfrg
uzskhw=whkszu
k=k
ep=pe
cosjmbbcho=ohcbbmjsoc
eozxl=lxzoe
zabmhvmz=zmvhmbaz
ltyaxxneji=ijenxxaytl
punx=xnup
lhv=vhl
lmaqeurjyw=wyjrueqaml
dzuyoj=joyuzd
e=e
lbcibiidb=bdiibicbl
z=z
sfwxxcb=bcxxwfs
cvxk=kxvc
pnyrjqvc=cvqjrynp
pnvtil=litvnp
luus=suul
ejr=rje
scycqndrt=trdnqcycs
mrb=brm
yokl=lkoy
jmscwuwcca=accwuwcsmj
ljerdtk=ktdrejl
jgwo=owgj
tq=qt
k=k
omewtzybtw=wtbyztwemo
xkmrgn=ngrmkx
sceaub=buaecs
uvcjlgce=ecgljcvu
na=an
u=u
cazabgp=pgbazac
eotyzepnrk=krnpezytoe
neogxufbd=dbfuxgoen
yx=xy
qxqusxkra=arkxsuqxq
cyca=acyc
oogftotje=ejtotfgoo
njmf=fmjn
dy=yd
v=v
gxyutlwqwg=gwqwltuyxg
fmu=umf
phb=bhp
yzmiezwcdr=rdcwzeimzy
j=j
ujqizjka=akjziqju
isgta=atgsi
z=z
jz=zj
gvrez=zervg
kxbq=qbxk
sqyamlhhsh=hshhlmayqs
fdygpki=ikpgydf
yx=xy
zvu=uvz
zrkrvduje=ejudvrkrz
hk=kh
e=e
plfpngvo=ovgnpflp
yaksnwqo=oqwnskay
osihydy=ydyhiso
bt=tb
mrpvlbzup=puzblvprm
rdqyvwokzp=pzkowvyqdr
rbwebtfqp=pqftbewbr
qcqojn=njoqcq
ctgtmtuiq=qiutmtgtc
d=d
vyubtigdpw=wpdgitbuyv
lizzddhu=uhddzzil
ilriw=wirli
ffqodwa=awdoqff
ulxgv=vgxlu
cyxadlzyrs=sryzldaxyc
eaiinjdgz=zgdjniiae
t=t
begilszd=dzsligeb
astsu=ustsa
fsqy=yqsf
lrkcqdza=azdqckrl
y=y
bdbzet=tezbdb
fomxxu=uxxmof
qnkdonqxa=axqnodknq
rpweemoosr=rsoomeewpr
ku=uk
wojn=njow
gnijmee=eemjing
jwhetvk=kvtehwj
qzfk=kfzq
siakkzsoe=eoszkkais
imx=xmi
z=z
lhnd=dnhl
bdjlq=qljdb
qjghtl=lthgjq
oynpj=jpnyo
clxgohqymk=kmyqhogxlc
ahpmlu=ulmpha
lzmcaxw=wxacmzl
yvkngz=zgnkvy
i=i
hiifkfcye=eycfkfiih
febd=dbef
dezjv=vjzed
t=t
ua=au
jgz=zgj
ncilvkx=xkvlicn
c=c
v=v
jaun=nuaj
hh=hh
fixawodf=fdowaxif
xdpxl=lxpdx
ejapsehqla=alqhespaje
vabyqvsbg=gbsvqybav
jd=dj
grj=jrg
orwbuhez=zehubwro
obzjaex=xeajzbo
ra=ar
ni=in
xtdfdgqz=zqgdfdtx
alcqli=ilqcla
zkdtfjq=qjftdkz
xbyw=wybx
fr=rf
ex=xe
j=j
knslr=rlsnk
jzqeiyl=lyieqzj
usueqffqaa=aaqffqeusu
m=m
pk=kp
wrvifp=pfivrw
prcnliqyvp=pvyqilncrp
zcujkeay=yaekjucz
rsoyyw=wyyosr
bmzvttxu=uxttvzmb
ehp=phe
scxwv=vwxcs
jj=jj
ntswip=piwstn
nl=ln
pug=gup
ajvhyte=etyhvja
ibqisnx=xnsiqbi
fctddk=kddtcf
dn=nd
jh=hj
gtcgbzs=szbgctg
ei=ie
k=k
o=o
sonuhkitmr=rmtikhunos
yruqxidiwu=uwidixqury
rrxfw=wfxrr
f=f
aolpaifb=bfiaploa
romyklpubo=obuplkymor
oo=oo
j=j
gt=tg
hwwalykl=lkylawwh
pakdpnkdxo=oxdknpdkap
hjkbkj=jkbkjh
petpezg=gzeptep
kgprmuoaj=jaoumrpgk
czcmy=ymczc
xdrwecdj=jdcewrdx
vvj=jvv
ldgg=ggdl
wtctpgmz=zmgptctw
gsvlogkiv=vikgolvsg
vv=vv
kbpojv=vjopbk
ugdrthe=ehtrdgu
nkfoah=haofkn
vopbckx=xkcbpov
gphhdz=zdhhpg
zfevzynk=knyzvefz
kpyn=nypk
uhgwkreve=everkwghu
sbtdyimns=snmiydtbs
nllde=edlln
bacalhu=uhlacab
ijij=jiji
edpko=okpde
vgutbttpm=mpttbtugv
wzq=qzw
b=b
nr=rn
mq=qm
jcfbn=nbfcj
tgljbofuzr=rzufobjlgt
toxskm=mksxot
uxbe=ebxu
psqvst=tsvqsp
ogdvfjljes=sejljfvdgo
vrlm=mlrv
wtp=ptw
enxkijbs=sbjikxne
ha=ah
bldp=pdlb
htsnsrgn=ngrsnsth
i=i
bdcditxr=rxtidcdb
ybj=jby
kifkyojgld=dlgjoykfik
foimrvuj=juvrmiof
crecqzfj=jfzqcerc
wvou=uovw
grcskarb=brakscrg
npqax=xaqpn
wjot=tojw
rcwcw=wcwcr
kqoqbx=xbqoqk
zubbzuq=quzbbuz
szt=tzs
bmdabybhb=bhbybadmb
ewojrbtjvr=rvjtbrjowe
bp=pb
flwnejt=tjenwlf
yphe=ehpy
ntcwefrztg=gtzrfewctn
dr=rd
kuxqjtsujg=gjustjqxuk
mxulxomkqr=rqkmoxluxm
fouecywf=fwyceuof
mxslkkkt=tkkklsxm
qbsor=rosbq
ai=ia
drzdu=udzrd
f=f
oyyyazguir=riugzayyyo
v=v
zwyzhbvqvx=xvqvbhzywz
gexububph=hpbubuxeg
gxgl=lgxg
pn=np
ctkrtmrisb=bsirmtrktc
e=e
fbrhvmv=vmvhrbf
shs=shs
hoofgpor=ropgfooh
prwsxb=bxswrp
w=w
cvn=nvc
jy=yj
alvhiuw=wuihvla
zl=lz
ob=bo
zvdb=bdvz
wwhoru=urohww
sb=bs
mp=pm
bypjr=rjpyb
zrr=rrz
nbhbvoj=jovbhbn
yitbzb=bzbtiy
ndlaqsdo=odsqaldn
mj=jm
bhgxtro=ortxghb
v=v
llvmsx=xsmvll
erw=wre
v=v
kmsxgymzs=szmygxsmk
ms=sm
mwbq=qbwm
bcra=arcb
dlat=tald
eak=kae
nirvv=vvrin
onlf=flno
hyruezdwoq=qowdzeuryh
yna=any
pwhv=vhwp
hp=ph
nmd=dmn
a=a
gpaxfqc=cqfxapg
ilsuvk=kvusli
fgbwox=xowbgf
otruq=qurto
yuioorb=brooiuy
fjroztyba=abytzorjf
vksz=zskv
slkf=fkls
yxiwbh=hbwixy
favrxik=kixrvaf
zxcnfzqdy=ydqzfncxz
oncuhpcx=xcphucno
li=il
ezr=rze
egpepo=opepge
i=i
b=b
anlbwn=nwblna
wa=aw
jeajyoijt=tjioyjaej
j=j
kcadc=cdack
vexzjbwh=hwbjzxev
dsh=hsd
ixokdk=kdkoxi
qxcqlhj=jhlqcxq
mxowzmc=cmzwoxm
tovhrma=amrhvot
hsry=yrsh
wkfmduq=qudmfkw
xvguaxs=sxaugvx
pzfryp=pyrfzp
piyl=lyip
zjrmiuka=akuimrjz
zswgwcef=fecwgwsz
v=v
xgkstuvpn=npvutskgx
hlbwgudc=cdugwblh
oocgt=tgcoo
vitpjp=pjptiv
juzv=vzuj
vty=ytv
wnjxnq=qnxjnw
luevjgyzv=vzygjveul
xythn=nhtyx
tpivn=nvipt
mggccr=rccggm
pktk=ktkp
ghec=cehg
yowzyfl=lfyzwoy
j=j
aiogvhv=vhvgoia
mpep=pepm
tzoyit=tiyozt
ozyndk=kdnyzo
qytoegpm=mpgeotyq
eebv=vbee
cfminji=ijnimfc
j=j
sz=zs
iq=qi
dbxb=bxbd
uat=tau
l=l
yenqnpa=apnqney
i=i
dnfuwechi=ihcewufnd
m=m
rddb=bddr
hjlkxho=ohxkljh
jqpcg=gcpqj
rj=jr
pp=pp
bpulm=mlupb
j=j
idifi=ifidi
ppvyg=gyvpp
fxqa=aqxf
qkmlyns=snylmkq
bvhjohkv=vkhojhvb
dtrstdfr=rfdtsrtd
dpzlwxsxl=lxsxwlzpd
imu=umi
xltwamjb=bjmawtlx
ttatjnghrp=prhgnjtatt
bzlx=xlzb
s=s
pll=llp
ocfcq=qcfco
itrogbxohu=uhoxbgorti
zcu=ucz
drslanv=vnalsrd
mjiizy=yziijm
mpl=lpm
yrd=dry
kxnbs=sbnxk
gervvh=hvvreg
amne=enma
kkfecdudsc=csdudcefkk
qzdpvp=pvpdzq
hr=rh
pxtmfsuhnq=qnhusfmtxp
mphewrusak=kasurwehpm
xzgwto=otwgzx
kqiyt=tyiqk
avda=adva
k=k
tk=kt
nvz=zvn
a=a
b=b
jqn=nqj
ttgjxcg=gcxjgtt
s=s
cbnmkawja=ajwakmnbc
ehkpagmfjd=djfmgapkhe
m=m
ixe=exi
rivb=bvir
cwr=rwc
rzbzbxni=inxbzbzr
xkj=jkx
vocusb=bsucov
nxtkbric=cirbktxn
vnamimzkn=nkzmimanv
w=w
ww=ww
wb=bw
hv=vh
vaeeq=qeeav
bvk=kvb
kkl=lkk
qhljxpugxf=fxgupxjlhq
zjxjw=wjxjz
suhekp=pkehus
sbxc=cxbs
fgjsv=vsjgf
dohtaslzlu=ulzlsathod
f=f
zn=nz
c=c
vziq=qizv
acwan=nawca
yqwiausg=gsuaiwqy
fzptfl=lftpzf
xbvoiyvt=tvyiovbx
mesce=ecsem
gb=bg
ujtwtfcbxi=ixbcftwtju
drmfjqmkeq=qekmqjfmrd
fwnya=aynwf
ubcmsg=gsmcbu
z=z
jkngjnewsy=yswenjgnkj
gcvghregax=xagerhgvcg
m=m
ewv=vwe
iviohpqepl=lpeqphoivi
r=r
p=p
ugsydgazf=fzagdysgu
zbfb=bfbz
qy=yq
ad=da
msfp=pfsm
bqyupnxckt=tkcxnpuyqb
ivbiodmoc=comdoibvi
po=op
ztksliurz=zruilsktz
t=t
qros=sorq
jnbescu=ucsebnj
bfnc=cnfb
boeonjg=gjnoeob
geu=ueg
jlv=vlj
vrzgw=wgzrv
badaisba=absiadab
wedcyoxrkq=qkrxoycdew
zrltkver=revktlrz
dghgu=ughgd
bba=abb
baq=qab
op=po
wnyfbrdr=rdrbfynw
vclddg=gddlcv
uoojyfhn=nhfyjoou
ac=ca
h=h
umc=cmu
otepghzrkh=hkrzhgpeto
pjjuz=zujjp
zyjuq=qujyz
bolr=rlob
xcp=pcx
gha=ahg
bwxknvpyuc=cuypvnkxwb
pmcx=xcmp
n=n
rkh=hkr
wmdkdb=bdkdmw
ffqc=cqff
lgcrff=ffrcgl
jwbozwyim=miywzobwj
nk=kn
sdbagxp=pxgabds
tzylaumyme=emymualyzt
tpa=apt
spoog=goops
eyqy=yqye
jflxgwzds=sdzwgxlfj
s=s
cktrwlemrp=prmelwrtkc
ibpws=swpbi
o=o
zptaagtqcx=xcqtgaatpz
xtazoo=oozatx
unft=tfnu
hpzipq=qpizph
ndixqgt=tgqxidn
utwnyhyesd=dseyhynwtu
zjxc=cxjz
wiodm=mdoiw
sei=ies
fo=of
cubrnuq=qunrbuc
spcikoaeuz=zueaokicps
spmhyblur=rulbyhmps
kemmflqwwr=rwwqlfmmek
v=v
elzm=mzle
a=a
mmgtkgo=ogktgmm
dxkltzwtvu=uvtwztlkxd
opqzahchpr=rphchazqpo
fedfsrs=srsfdef
mkvpwbuu=uubwpvkm
j=j
asijjh=hjjisa
iaecbpvi=ivpbceai
kzfcvbkp=pkbvcfzk
n=n
ixtxovk=kvoxtxi
gtsntih=hitnstg
sstgoindh=hdniogtss
kz=zk
tr=rt
s=s
dnrpvfp=pfvprnd
caf=fac
rbvwxvhkcg=gckhvxwvbr
pmftpfjsyn=nysjfptfmp
fk=kf
usvhkp=pkhvsu
zql=lqz
ugxj=jxgu
kcqzpubjgz=zgjbupzqck
zqxvgpt=tpgvxqz
n=n
jemctr=rtcmej
ikydm=mdyki
qpfkjeeoa=aoeejkfpq
nnxbk=kbxnn
twxo=oxwt
kpbao=oabpk
o=o
mbqmztrxr=rxrtzmqbm
uaqahl=lhaqau
lrpv=vprl
vsaz=zasv
bwyywzsgv=vgszwyywb
k=k
w=w
cpud=dupc
fdmrion=noirmdf
xu=ux
t=t
guc=cug
jpptqek=keqtppj
u=u
ke=ek
jios=soij
kqs=sqk
oqqmallk=kllamqqo
bfk=kfb
acngdxqki=ikqxdgnca
ajah=haja
cuabt=tbauc
haiitnmq=qmntiiah
ion=noi
fngkoipg=gpiokgnf
wkgugyh=hygugkw
vnsibrjl=ljrbisnv
kbrysulz=zlusyrbk
dkl=lkd
somsjox=xojsmos
hbvk=kvbh
mfo=ofm
bf=fb
gcuaynjk=kjnyaucg
fx=xf
jetbstj=jtsbtej
h=h
psngv=vgnsp
qy=yq
wegldpu=updlgew
ormxj=jxmro
jzhzixwa=awxizhzj
p=p
phe=ehp
l=l
guiayjcb=bcjyaiug
vsamy=ymasv
zhrhagysl=lsygahrhz
ukh=hku
e=e
r=r
yihpb=bphiy
rqbtpxze=ezxptbqr
htrnfiv=vifnrth
gyxjatriio=oiirtajxyg
kwpagvgej=jegvgapwk
wtssfxrs=srxfsstw
pfmikvl=lvkimfp
fmefrfj=jfrfemf
armxpezjh=hjzepxmra
qwjoavtgt=tgtvaojwq
hhsbt=tbshh
oi=io
jt=tj
if=fi
ruelg=gleur
nhahsr=rshahn
jorlkybp=pbyklroj
b=b
imb=bmi
sjjzxi=ixzjjs
cu=uc
vejulonn=nnolujev
ep=pe
tqbfzm=mzfbqt
tasjlsrsn=nsrsljsat
akhtiretrl=lrterithka
gyxa=axyg
v=v
lkppflau=ualfppkl
dvvr=rvvd
dswugnvn=nvnguwsd
ry=yr
mvcbnd=dnbcvm
artug=gutra
ndu=udn
zo=oz
ntkmptbkx=xkbtpmktn
mnkrn=nrknm
dt=td
ca=ac
bdlmpnvmxe=exmvnpmldb
wtejntllp=plltnjetw
lvgcdix=xidcgvl
ib=bi
ymd=dmy
yzie=eizy
kbjuqpjp=pjpqujbk
daizbukwu=uwkubziad
mmco=ocmm
xcbytzitba=abtiztybcx
yj=jy
lorulvzhfw=wfhzvlurol
yjm=mjy
cvgyppstrq=qrtsppygvc
fgm=mgf
atpkngqqdr=rdqqgnkpta
zjyr=ryjz
qbfagjjwl=lwjjgafbq
mmgspxg=gxpsgmm
oj=jo
abybi=ibyba
x=x
jcxj=jxcj
rryvkeeivj=jvieekvyrr
lfqdfxur=ruxfdqfl
ftclsbcrv=vrcbslctf
jjfxdzvs=svzdxfjj
rmvfvwtgm=mgtwvfvmr
tf=ft
rrt=trr
pj=jp
vdaco=ocadv
fmjppxcqi=iqcxppjmf
eaezj=jzeae
pmmx=xmmp
enragbydbb=bbdybgarne
cpwxzushuj=juhsuzxwpc
oacqvegeqr=rqegevqcao
jbwj=jwbj
yqwgmct=tcmgwqy
rgdbmgezn=nzegmbdgr
cgtpyfpvtq=qtvpfyptgc
xsoidyo=oydiosx
xdyizd=dziydx
p=p
csnilf=flinsc
squryya=ayyruqs
uvbcyxf=fxycbvu
nhef=fehn
wdb=bdw
vh=hv
vhm=mhv
knayzwsucg=gcuswzyank
ouled=deluo
xulvbv=vbvlux
klbpi=ipblk
d=d
sfzxam=maxzfs
szbhgefyut=tuyfeghbzs
jijv=vjij
s=s
dsxkfsi=isfkxsd
exx=xxe
cunqntqch=hcqtnqnuc
f=f
sb=bs
rkycrj=jrcykr
dme=emd
aucy=ycua
prxgejzmaa=aamzjegxrp
eblfzzszao=oazszzflbe
ysxd=dxsy
m=m
snqpzwm=mwzpqns
aber=reba
cpu=upc
lnpoz=zopnl
v=v
nyew=weyn
vdchik=kihcdv
x=x
vqruk=kurqv
osm=mso
cqwltg=gtlwqc
eyd=dye
pwps=spwp
kplxvmi=imvxlpk
rbxuxaew=weaxuxbr
yxvgendd=ddnegvxy
v=v
tbsysafyo=oyfasysbt
rbjs=sjbr
skfkxmjlon=noljmxkfks
movkb=bkvom
tznbq=qbnzt
bxsyhuqc=cquhysxb
ftegmukhoo=oohkumgetf
fxek=kexf
lzeleknuu=uunkelezl
rjnsqlaepf=fpealqsnjr
ycxmew=wemxcy
ywnhch=hchnwy
livogcqppk=kppqcgovil
pnedhp=phdenp
ocre=erco
dyqiloqqrh=hrqqoliqyd
efcsw=wscfe
ecejbbwud=duwbbjece
d=d
zeckrbvts=stvbrkcez
xz=zx
dqnoutu=utuonqd
oroqvxx=xxvqoro
ufg=gfu
frasx=xsarf
azdr=rdza
fufclumh=hmulcfuf
eqcxynb=bnyxcqe
uxbgqoyoeg=geoyoqgbxu
addwuy=yuwdda
ymdu=udmy
zj=jz
eqht=thqe
fmfjoyskd=dksyojfmf
fgabp=pbagf
e=e
punrpo=oprnup
ulzsbwe=ewbszlu
fdakwdzwh=hwzdwkadf
zipef=fepiz
gorobibssn=nssbiborog
yj=jy
gukx=xkug
arttqnqyc=cyqnqttra
faiuxy=yxuiaf
wvrxi=ixrvw
wurhr=rhruw
vzocpsyjhu=uhjyspcozv
ej=je
hfgadgor=rogdagfh
pwpirxal=laxripwp
vxr=rxv
slfgjxktkp=pktkxjgfls
jmsfgs=sgfsmj
xmksoyras=saryoskmx
skxg=gxks
jvchjah=hajhcvj
dmespqga=agqpsemd
hcj=jch
aztuojp=pjoutza
zpjsaimdxl=lxdmiasjpz
fibsesscj=jcssesbif
yydsvfbfk=kfbfvsdyy
m=m
ufjlbplex=xelpbljfu
tmtrckxq=qxkcrtmt
knpk=kpnk
lnkjd=djknl
ovytuqm=mqutyvo
jhyatq=qtayhj
fd=df
sniobo=oboins
qgileobae=eaboeligq
fmdu=udmf
vvhjhbryvu=uvyrbhjhvv
o=o
dxjxsw=wsxjxd
vjfhetrob=bortehfjv
yfjio=oijfy
uysv=vsyu
dhratk=ktarhd
pzrjkd=dkjrzp
qmkfu=ufkmq
wswvd=dvwsw
oijt=tjio
cffeh=heffc
yqiaqr=rqaiqy
q=q
teuvutnms=smntuvuet
omouqgbae=eabgquomo
zc=cz
u=u
ucscegti=itgecscu
aivikmiqr=rqimkivia
guhqtek=ketqhug
wtkbd=dbktw
eaafxslgwk=kwglsxfaae
j=j
lzelynmd=dmnylezl
rbvsgcducz=zcudcgsvbr
ejnsiuczu=uzcuisnje
nedasha=ahsaden
lpklk=klkpl
nueebqu=uqbeeun
xeurvlvv=vvlvruex
ejktulxtc=ctxlutkje
az=za
nonttsvcn=ncvsttnon
ksjzktu=utkzjsk
zdakxbixkm=mkxibxkadz
kvifry=yrfivk
cn=nc
nkukg=gkukn
gwbldkbiv=vibkdlbwg
xlmj=jmlx
qd=dq
bnqtvothyd=dyhtovtqnb
wgvzk=kzvgw
bbqf=fqbb
kpuvt=tvupk
anfvviau=uaivvfna
jnnkab=baknnj
wtc=ctw
rpio=oipr
ygkb=bkgy
ihu=uhi
cp=pc
pbqhyy=yyhqbp
icvzpdstgy=ygtsdpzvci
cgd=dgc
fzucrwljrz=zrjlwrcuzf
nevhqmp=pmqhven
yajnuzw=wzunjay
wxcrrdqws=swqdrrcxw
plo=olp
zktkvd=dvktkz
wkevh=hvekw
sjr=rjs
bcvolyzu=uzylovcb
unrekr=rkernu
oxxf=fxxo
qba=abq
my=ym
yljutpt=tptujly
qc=cq
pdbdxsfli=ilfsxdbdp
wgroxygktj=jtkgyxorgw
utg=gtu
y=y
kwejrg=grjewk
vskiidikl=lkidiiksv
nseuky=ykuesn
canbfqi=iqfbnac
nw=wn
ysvqpve=evpqvsy
bkhczkq=qkzchkb
dtcngtit=titgnctd
aqzaj=jazqa
qgn=ngq
bnyqy=yqynb
tucchb=bhccut
jljqbapp=ppabqjlj
atsn=nsta
yr=ry
asrzj=jzrsa
ieht=thei
jjbtfvds=sdvftbjj
qxuq=quxq
odbmzpt=tpzmbdo
bd=db
peahjeaimi=imiaejhaep
umru=urmu
vzvz=zvzv
vdgjrfa=afrjgdv
jfvfstulv=vlutsfvfj
obz=zbo
ywbolfssq=qssflobwy
ngacz=zcagn
r=r
edaduhfn=nfhudade
olplczihmb=bmhizclplo
wmr=rmw
cfjrep=perjfc
k=k
mcc=ccm
jtncgmxs=sxmgcntj
wetxfcc=ccfxtew
wpbcdtl=ltdcbpw
xgxfdmbv=vbmdfxgx
fvii=iivf
yw=wy
j=j
eurtojnmm=mmnjotrue
cdk=kdc
g=g
j=j
ncs=scn
icadudzarv=vrazdudaci
larrisbm=mbsirral
slivyx=xyvils
dxai=iaxd
a=a
scavh=hvacs
vapabxo=oxbapav
agzgwybdss=ssdbywgzga
qpusk=ksupq
gvf=fvg
iryve=evyri
rdzz=zzdr
lqsihey=yehisql
vwyib=biywv
thiaul=luaiht
uezcj=jczeu
u=u
nbohyhzmd=dmzhyhobn
kzxzan=nazxzk
upzdhxlv=vlxhdzpu
amodzsq=qszdoma
scg=gcs
kvfxzleq=qelzxfvk
qbi=ibq
subdof=fodbus
xfrl=lrfx
jumxovh=hvoxmuj
kmwvshyta=atyhsvwmk
epdkuu=uukdpe
rwzqh=hqzwr
h=h
hrjrotvn=nvtorjrh
jomgfkmkbn=nbkmkfgmoj
nodx=xdon
uc=cu
daklgutac=catuglkad
u=u
jnhd=dhnj
zz=zz
ketpc=cptek
utuk=kutu
z=z
gywznljkz=zkjlnzwyg
aaoj=joaa
ynlhpiczyb=byzciphlny
ko=ok
cqaw=waqc
fawdly=yldwaf
cuxuibm=mbiuxuc
ettakxixr=rxixkatte
wzfaknz=znkafzw
osjuqnqo=oqnqujso
eezgspstjy=yjtspsgzee
kyujrl=lrjuyk
as=sa
v=v
tqeohq=qhoeqt
liddmmo=ommddil
nkvaqtt=ttqavkn
lzfpxq=qxpfzl
muk=kum
rrwhaqovi=ivoqahwrr
bqunuomdjo=ojdmounuqb
qwf=fwq
skxsjzahfo=ofhazjsxks
lnfxvxwdna=andwxvxfnl
rbfocnsf=fsncofbr
eirphiw=wihprie
a=a
rujdv=vdjur
s=s
yythoednfk=kfndeohtyy
gdjgozpaoi=ioapzogjdg
bufplkk=kklpfub
xrwsmfk=kfmswrx
jpny=ynpj
q=q
bjsj=jsjb
cbahthu=uhthabc
sgs=sgs
qkthiwc=cwihtkq
srt=trs
dezaysxb=bxsyazed
wmw=wmw
wwsmahwvsy=ysvwhamsww
vuefzmbx=xbmzfeuv
f=f
rfxrvw=wvrxfr
naiuxugsk=ksguxuian
zbjqqzjyl=lyjzqqjbz
stzvxo=oxvzts
bvphebr=rbehpvb
ernd=dnre
jgkxzoa=aozxkgj
jcjafwygth=htgywfajcj
wyqrennaaa=aaannerqyw
fqfplrl=lrlpfqf
pqxvhuu=uuhvxqp
zfyz=zyfz
dqhw=whqd
npgjvb=bvjgpn
dp=pd
m=m
afkexe=exekfa
yhizuabi=ibauzihy
ydfpkeix=xiekpfdy
a=a
z=z
ukekx=xkeku
yacuqweqno=onqewqucay
ibhf=fhbi
igeu=uegi
zlnxbqser=resqbxnlz
er=re
abat=taba
lidjkla=alkjdil
d=d
k=k
qm=mq
badsvyia=aiyvsdab
ghcy=ychg
zjnebll=llbenjz
uoooz=zooou
umwnb=bnwmu
ejrdycndnd=dndncydrje
lwy=ywl
bfaunjh=hjnuafb
defay=yafed
rj=jr
hvbodrbtc=ctbrdobvh
ylbhfokkrj=jrkkofhbly
iyd=dyi
ylgmfb=bfmgly
qaeaxrjl=ljrxaeaq
qvfpoemnc=cnmeopfvq
sy=ys
wpfy=yfpw
zhepoagal=lagaopehz
sbxpjah=hajpxbs
wcu=ucw
zpf=fpz
ns=sn
sw=ws
zpzpbymxr=rxmybpzpz
tgwypxbf=fbxpywgt
z=z
lxyws=swyxl
ftaqjnacx=xcanjqatf
wl=lw
obxwiwvvhm=mhvvwiwxbo
ntuifbymk=kmybfiutn
gfl=lfg
zxv=vxz
clhorjyc=cyjrohlc
ksxqcdb=bdcqxsk
cj=jc
lgmpjz=zjpmgl
o=o
hnuqvrw=wrvqunh
pzzqvotbai=iabtovqzzp
wguzcnx=xnczugw
n=n
vn=nv
wzdtiivtv=vtviitdzw
qusgxj=jxgsuq
gqlaah=haalqg
qmttm=mttmq
cwm=mwc
qmqlwkil=likwlqmq
ytwvm=mvwty
zod=doz
zprhi=ihrpz
zrbwbvub=buvbwbrz
tcsxrlfopz=zpoflrxsct
ckqpuvwkjm=mjkwvupqkc
nwg=gwn
ahwpkr=rkpwha
mfqugk=kguqfm
whc=chw
iuniros=sorinui
rmavkys=sykvamr
dnpg=gpnd
o=o
etmahb=bhamte
fxopm=mpoxf
ld=dl
fdbzor=rozbdf
xche=ehcx
anjxd=dxjna
rnkqas=saqknr
ep=pe
euuqsm=msquue
i=i
ncugeoydj=jdyoegucn
pdwrwqsy=ysqwrwdp
bnwj=jwnb
zrjsxckip=pikcxsjrz
emimomn=nmomime
ykfnsxdl=ldxsnfky
rc=cr
hbdrncs=scnrdbh
xvpeac=caepvx
vzdxb=bxdzv
bikwzmsnfz=zfnsmzwkib
jg=gj
zmzjk=kjzmz
monc=cnom
kmldan=nadlmk
jgdhiebd=dbeihdgj
qeqij=jiqeq
nqygawub=buwagyqn
qiyjytlzk=kzltyjyiq
wkxlf=flxkw
ti=it
qdb=bdq
zgzfsxyevk=kveyxsfzgz
wmsmhao=oahmsmw
aobue=euboa
hwtmgfrkju=ujkrfgmtwh
d=d
jbvto=otvbj
wpv=vpw
jmzz=zzmj
nmrqmp=pmqrmn
johblfkajo=ojakflbhoj
ducz=zcud
yzhmsiacp=pcaismhzy
zkp=pkz
j=j
y=y
x=x
nvhrpv=vprhvn
vywqeljjy=yjjleqwyv
tuqwrwiwbw=wbwiwrwqut
tjzfpgg=ggpfzjt
nhcpzfdyb=bydfzpchn
dhuq=quhd
guzccf=fcczug
glykih=hikylg
tit=tit
sgjalbfqza=azqfblajgs
ymbkply=ylpkbmy
jrorlvquav=vauqvlrorj
wkffqtzcb=bcztqffkw
sl=ls
lyjfwtlk=kltwfjyl
fjiyew=weyijf
kcuf=fuck
xmmlgeboom=moobeglmmx
dc=cd
dazx=xzad
qogvlfpx=xpflvgoq
trdk=kdrt
dfoydnrck=kcrndyofd
ptxe=extp
luweaw=waewul
sqxi=ixqs
cqnce=ecnqc
llrujlqge=egqljurll
gw=wg
tbzmnhkys=sykhnmzbt
m=m
eek=kee
yggg=gggy
njp=pjn
oshb=bhso
ublgip=piglbu
wlgjc=cjglw
cynpgrbm=mbrgpnyc
qybreeoj=joeerbyq
lx=xl
irhy=yhri
pbht=thbp
va=av
mdjdwnrzac=cazrnwdjdm
dqxqzybp=pbyzqxqd
gtmy=ymtg
mfxvemzxk=kxzmevxfm
bpvjqm=mqjvpb
y=y
wqrnt=tnrqw
qoxsihyzx=xzyhisxoq
ifsgymadtk=ktdamygsfi
frphwedr=rdewhprf
jhje=ejhj
mjdk=kdjm
yousoj=josuoy
c=c
qfafspba=abpsfafq
xemjeezwra=arwzeejmex
r=r
dulljcgxi=ixgcjllud
vwvlfjfia=aifjflvwv
iyky=ykyi
atgkhbi=ibhkgta
yxajdfy=yfdjaxy
hqfob=bofqh
tmtda=adtmt
qimaby=ybamiq
vnsq=qsnv
sxgbc=cbgxs
xesytwt=twtysex
tasrvcb=bcvrsat
udevwxky=ykxwvedu
glwmkusjz=zjsukmwlg
tox=xot
jp=pj
iniwtfyuix=xiuyftwini
n=n
fydqgez=zegqdyf
xcufeziyfq=qfyizefucx
yirs=sriy
jgcc=ccgj
eetbmck=kcmbtee
odzkawqjeo=oejqwakzdo
pkxc=cxkp
vfshvmtl=ltmvhsfv
tfvk=kvft
zlut=tulz
fcrab=barcf
eqtzcmn=nmcztqe
tm=mt
klvgybp=pbygvlk
ivqya=ayqvi
r=r
qll=llq
j=j
hhkuvzt=tzvukhh
aobzyy=yyzboa
pgcuvgal=lagvucgp
mbglrfskg=gksfrlgbm
qwsrvdk=kdvrswq
rmgqc=cqgmr
irmkmprfch=hcfrpmkmri
prjdtezjl=ljzetdjrp
p=p
qdfre=erfdq
x=x
znpkhy=yhkpnz
aimxlzq=qzlxmia
lcu=ucl
yjokkfonq=qnofkkojy
pchenque=euqnehcp
k=k
eo=oe
msfinrn=nrnifsm
asfwxzen=nezxwfsa
u=u
dxfdwp=pwdfxd
x=x
jop=poj
lvlk=klvl
gcfgvxq=qxvgfcg
kysvgtjvl=lvjtgvsyk
uotbyzmpdx=xdpmzybtou
bqqqqp=pqqqqb
mejtt=ttjem
dquyckro=orkcyuqd
ee=ee
qsfwcc=ccwfsq
woafdf=fdfaow
lkol=lokl
zddxzekqa=aqkezxddz
eyqqcs=scqqye
d=d
aclnxkh=hkxnlca
wnxwll=llwxnw
x=x
osiby=ybiso
bmecjj=jjcemb
h=h
tztheljo=ojlehtzt
innwlaadyo=oydaalwnni
jfsuvqxczv=vzcxqvusfj
smsftwvi=ivwtfsms
suypnxhc=chxnpyus
ezzcdltqw=wqtldczze
zuyvrf=frvyuz
sifadt=tdafis
uxjnsruk=kursnjxu
twv=vwt
x=x
bldtobn=nbotdlb
lsoymzxdft=tfdxzmyosl
hsvbceqzr=rzqecbvsh
dbzw=wzbd
nnwgojfdxj=jxdfjogwnn
ekgsv=vsgke
xqowp=pwoqx
sihvnduycw=wcyudnvhis
fscg=gcsf
wczpm=mpzcw
enzw=wzne
eyjjnd=dnjjye
bvuyvld=dlvyuvb
jntwzpnbl=lbnpzwtnj
e=e
ke=ek
effdhg=ghdffe
yz=zy
x=x
ulgplmfi=ifmlpglu
wulxzhxxw=wxxhzxluw
sghlqjq=qjqlhgs
aixqhbiv=vibhqxia
qxnj=jnxq
dt=td
xoahn=nhaox
bskus=suksb
vzjuzui=iuzujzv
gqlpwcach=hcacwplqg
aupaga=agapua
xwqkkf=fkkqwx
rvxca=acxvr
zozekm=mkezoz
ssqeiyoabh=hbaoyieqss
idbscl=lcsbdi
rebpddkf=fkddpber
vecbpujr=rjupbcev
azzqgpfsyx=xysfpgqzza
bztx=xtzb
seah=haes
eqqk=kqqe
rulcqpvcoj=jocvpqclur
djvbdjee=eejdbvjd
sy=ys
y=y
nwtap=patwn
fgdfylfst=tsflyfdgf
dmfieuytok=kotyueifmd
px=xp
j=j
acgrjzgb=bgzjrgca
wfxhsfgc=cgfshxfw
nvaivaj=javiavn
fz=zf
dm=md
pdnuyfbfm=mfbfyundp
ivobh=hbovi
xbkppimpzp=pzpmippkbx
sfms=smfs
coc=coc
ivnmy=ymnvi
qbvqxbnh=hnbxqvbq
hktpep=peptkh
snexfeuc=cuefxens
s=s
tzyqiraj=jariqyzt
r=r
er=re
ixihcqpyq=qypqchixi
bfxcuvu=uvucxfb
equsbxhklp=plkhxbsuqe
yostdpyqlt=tlqypdtsoy
gcovsegtph=hptgesvocg
iwhrrwnah=hanwrrhwi
rh=hr
e=e
gkwqawav=vawaqwkg
yqrua=aurqy
gzhbthyy=yyhtbhzg
o=o
vgrhkhg=ghkhrgv
iawtxzm=mzxtwai
fdpsdbfnr=rnfbdspdf
r=r
dc=cd
j=j
wlensfbe=ebfsnelw
xateqlqzu=uzqlqetax
nhwym=mywhn
pnysw=wsynp
myecjmu=umjceym
z=z
xemtpk=kptmex
bvdxlvvrls=slrvvlxdvb
ehtmnfxp=pxfnmthe
qz=zq
xhd=dhx
dx=xd
sdouuauuzj=jzuuauuods
vujrsommz=zmmosrjuv
trfzmno=onmzfrt
amxugjylbi=iblyjguxma
edvixkv=vkxivde
z=z
kinfh=hfnik
qzjnisbfk=kfbsinjzq
hyr=ryh
koxpshcpee=eepchspxok
zkq=qkz
ashkfd=dfkhsa
pq=qp
z=z
vvansrk=krsnavv
mxvwsizl=lziswvxm
ulnvteqvb=bvqetvnlu
dbqtsevll=llvestqbd
ot=to
ysqpsvbu=ubvspqsy
yairvqvdtb=btdvqvriay
xqfh=hfqx
ret=ter
ccvb=bvcc
mrod=dorm
ppcqpvjn=njvpqcpp
ovehzjm=mjzhevo
sjrflwnglh=hlgnwlfrjs
msraot=toarsm
swfx=xfws
w=w
k=k
edrkre=erkrde
vg=gv
feaoiru=urioaef
mz=zm
xfnjcrf=frcjnfx
luv=vul
jgcondf=fdnocgj
q=q
ibwcewsrsl=lsrswecwbi
zdurekok=kokerudz
bfngfmnpb=bpnmfgnfb
eo=oe
limwq=qwmil
tdhve=evhdt
fc=cf
e=e
h=h
gfhvzulni=inluzvhfg
lb=bl
tpttdlz=zldttpt
fs=sf
eukmlc=clmkue
lxdncdis=sidcndxl
dkne=enkd
ibjonkdyng=gnydknojbi
pprf=frpp
htgejzxrck=kcrxzjegth
iwwbudeq=qedubwwi
sgkmiilglq=qlgliimkgs
arpwella=allewpra
hb=bh
bh=hb
qymt=tmyq
bsxevcpwss=sswpcvexsb
fmrmbzg=gzbmrmf
gufxffqj=jqffxfug
teshuuhu=uhuuhset
zm=mz
d=d
jvzfgfdjc=cjdfgfzvj
r=r
glvmqsw=wsqmvlg
tpsue=euspt
gycvfwn=nwfvcyg
pcacqtqzqf=fqzqtqcacp
bigfmimxs=sxmimfgib
q=q
oziqj=jqizo
tilkpkixdo=odxikpklit
mj=jm
m=m
aqees=seeqa
zsabvgz=zgvbasz
mkmtghhdx=xdhhgtmkm
thkdsp=psdkht
edltyixex=xexiytlde
log=gol
jtan=natj
bxoonpcizl=lzicpnooxb
iwwuhibbh=hbbihuwwi
rooavfftia=aitffvaoor
udoequlfcm=mcfluqeodu
du=ud
lpnqomhe=ehmoqnpl
q=q
csxtxjrcf=fcrjxtxsc
djfseg=gesfjd
u=u
vrsjp=pjsrv
bpobrxb=bxrbopb
dozisybdop=podbysizod
gghvuoygbn=nbgyouvhgg
z=z
gqe=eqg
qtwt=twtq
ztfnmoj=jomnftz
pfylob=bolyfp
fljcmx=xmcjlf
fzq=qzf
bhzhemvett=ttevmehzhb
uvhlmb=bmlhvu
fdbht=thbdf
y=y
blzryh=hyrzlb
cw=wc
ulake=ekalu
kfmvyfm=mfyvmfk
utexnrolu=ulornxetu
rkyn=nykr
wwqgpv=vpgqww
mojnvldthu=uhtdlvnjom
ylq=qly
gkqqfhgr=rghfqqkg
kconmyilq=qliymnock
ogxdsno=onsdxgo
m=m
nyhghdsm=msdhghyn
mwmqihgwo=owghiqmwm
fxf=fxf
sgqtfouvmu=umvuoftqgs
wx=xw
ecankc=cknace
wvu=uvw
ygbjpwogbj=jbgowpjbgy
rzqjye=eyjqzr
czzefzrk=krzfezzc
mubo=obum
sgyaioyjjd=djjyoiaygs
egasvwu=uwvsage
qpclfnmbg=gbmnflcpq
ihslnqiryb=byriqnlshi
vmxo=oxmv
gdbrqqsy=ysqqrbdg
zrifmfuemt=tmeufmfirz
tekeerxhup=puhxreeket
fiwsnzqg=gqznswif
lmxeq=qexml
msil=lism
marlsd=dslram
r=r
nrlpmfqa=aqfmplrn
prumcu=ucmurp
opwov=vowpo
wgcicb=bcicgw
wjxbvlul=lulvbxjw
vqqpqnu=unqpqqv
oekftk=ktfkeo
deeyzxoi=ioxzyeed
zwrixl=lxirwz
wzssuod=dousszw
jtpv=vptj
tajytodto=otdotyjat
xfw=wfx
csbeikz=zkiebsc
sekxvkpngz=zgnpkvxkes
wtwgyuolsx=xslouygwtw
osxvxanj=jnaxvxso
gnuijou=uojiung
te=et
obxt=txbo
acblrugzly=ylzgurlbca
pwuoquwr=rwuqouwp
sjz=zjs
dda=add
dnce=ecnd
jeypcrz=zrcpyej
pp=pp
gom=mog
xiys=syix
przfirlr=rlrifzrp
gldbgjauv=vuajgbdlg
f=f
rw=wr
ojdcym=mycdjo
u=u
ahrbbor=robbrha
awfoxyom=moyxofwa
sdqdjukemw=wmekujdqds
cpxcc=ccxpc
eodlbu=ubldoe
cd=dc
bvnruhe=ehurnvb
in=ni
xy=yx
pursjwypwp=pwpywjsrup
ptqizgi=igziqtp
hyflgt=tglfyh
qvnusrkd=dkrsunvq
yea=aey
vaxootc=ctooxav
xtotrfmfrn=nrfmfrtotx
rqfhoub=buohfqr
snsgy=ygsns
ajbjfotp=ptofjbja
euryrxng=gnxryrue
nabm=mban
woyhfn=nfhyow
wgkslbl=lblskgw
j=j
rkq=qkr
plf=flp
nsrdxqwe=ewqxdrsn
rlxjhat=tahjxlr
ljap=pajl
alqyx=xyqla
bxs=sxb
irpa=apri
npw=wpn
incd=dcni
uwgvgwpfrh=hrfpwgvgwu
ylvrprnz=znrprvly
ykzvmfsjuf=fujsfmvzky
cx=xc
lsuhwvj=jvwhusl
beg=geb
najabvzdy=ydzvbajan
okrbka=akbrko
k=k
zffclx=xlcffz
qixgoi=iogxiq
s=s
dviuujd=djuuivd
gdcvzoxsuk=kusxozvcdg
qivdja=ajdviq
phpehcc=cchephp
svqa=aqvs
egrpm=mprge
njdpqovvyt=tyvvoqpdjn
a=a
dbnmv=vmnbd
qaqzhaf=fahzqaq
cmsjt=tjsmc
hbkzgnef=fengzkbh
uayw=wyau
mlepfbuxeq=qexubfpelm
d=d
zxmeo=oemxz
ezmllppgv=vgppllmze
kfsonw=wnosfk
hurwnfyxlt=tlxyfnwruh
c=c
xbrae=earbx
ailxvewh=hwevxlia
ilxxrvqobt=tboqvrxxli
v=v
ogjzyvaaju=ujaavyzjgo
tat=tat
zru=urz
xlpx=xplx
lie=eil
ilvhnfps=spfnhvli
fbws=swbf
zqwshqlj=jlqhswqz
eshir=rihse
efg=gfe
qvfr=rfvq
jmlop=polmj
ljwwkgdh=hdgkwwjl
xoiu=uiox
kkew=wekk
sie=eis
m=m
axzrmtx=xtmrzxa
rqwm=mwqr
vfuondb=bdnoufv
y=y
qvrt=trvq
xrbdequz=zuqedbrx
pqxsfqvc=cvqfsxqp
qfcmj=jmcfq
scgllxzzjm=mjzzxllgcs
ghlgctlg=gltcglhg
yqfnfgouem=meuogfnfqy
cpmjcplzum=muzlpcjmpc
dqkumlgn=nglmukqd
bb=bb
tqswagqqjc=cjqqgawsqt
avppx=xppva
q=q
egfah=hafge
udhsxmcmd=dmcmxshdu
mau=uam
kv=vk
n=n
hamrblb=blbrmah
mn=nm
knvx=xvnk
evji=ijve
vrppgpndwb=bwdnpgpprv
u=u
gfxa=axfg
q=q
mzpgmtig=gitmgpzm
zrzpxauyfc=cfyuaxpzrz
zfygci=icgyfz
kmhkdkb=bkdkhmk
lehe=ehel
ugcfs=sfcgu
iamneanh=hnaenmai
rgg=ggr
mcypfdwbj=jbwdfpycm
wdswvuab=bauvwsdw
mzi=izm
heqygiull=lluigyqeh
ql=lq
bdaccj=jccadb
dba=abd
vhtpc=cpthv
q=q
wwhcjtpfgt=tgfptjchww
ye=ey
izbbm=mbbzi
muzaga=agazum
bq=qb
qrfo=ofrq
jybs=sbyj
sn=ns
ceivka=akviec
ohynbeekxt=txkeebnyho
qrazyk=kyzarq
mgcdagyuls=sluygadcgm
bimd=dmib
ozjbrm=mrbjzo
xiz=zix
ytnrxd=dxrnty
fghmsdvm=mvdsmhgf
ftgypalt=tlapygtf
wrqhmhwsn=nswhmhqrw
bsass=ssasb
bzcphl=lhpczb
xkjw=wjkx
kzxhkgx=xgkhxzk
eop=poe
gw=wg
w=w
uyqwpfsowu=uwosfpwqyu
leggij=jiggel
iqdakhoq=qohkadqi
fnyabfoj=jofbaynf
hyllues=seullyh
eorlsadddk=kdddaslroe
ojobxbkupw=wpukbxbojo
fpdawqnrm=mrnqwadpf
gqrqqsewia=aiwesqqrqg
cebwhlu=ulhwbec
gv=vg
mxir=rixm
lb=bl
uzrf=frzu
ssswc=cwsss
uwuz=zuwu
wnlrhpl=lphrlnw
rg=gr
b=b
uu=uu
ypubghthi=ihthgbupy
xxts=stxx
herswgtk=ktgwsreh
qsgymbapl=lpabmygsq
ytj=jty
llilqdk=kdqlill
ziaz=zaiz
av=va
c=c
ldh=hdl
uoof=foou
ntkcjzqow=woqzjcktn
qulhlxbeau=uaebxlhluq
twzwib=biwzwt
oqlldlu=uldllqo
t=t
rypvgd=dgvpyr
pjmigsiqd=dqisgimjp
yzaw=wazy
ryt=tyr
tyrbpmh=hmpbryt
g=g
mpadhyvzn=nzvyhdapm
ucxk=kxcu
ryoshhud=duhhsoyr
rab=bar
nfkblv=vlbkfn
dr=rd
twfnlxy=yxlnfwt
uzmdvk=kvdmzu
grgduciwn=nwicudgrg
yhpvfrrl=lrrfvphy
pmpeiat=taiepmp
rfhyw=wyhfr
cdhusxtceu=uectxsuhdc
gzfl=lfzg
fqcjmt=tmjcqf
miajsfvskj=jksvfsjaim
gisxya=ayxsig
gu=ug
hvogwqogar=ragoqwgovh
umvgcpoda=adopcgvmu
uptepdvbss=ssbvdpetpu
xluosxt=txsoulx
ovfg=gfvo
ffm=mff
gbrndl=ldnrbg
cqddybdbs=sbdbyddqc
owyrosqrux=xurqsorywo
qtv=vtq
acxvwlv=vlwvxca
dhfgaoepmv=vmpeoagfhd
mprylgwrnj=jnrwglyrpm
de=ed
yunout=tuonuy
asnkznst=tsnzknsa
sxnbzh=hzbnxs
goyeaqk=kqaeyog
qefsnajld=dljansfeq
swy=yws
nmmybriy=yirbymmn
lp=pl
narqdygl=lgydqran
sovompi=ipmovos
hswrqeyql=lqyeqrwsh
q=q
gugatmv=vmtagug
ikdxqhumw=wmuhqxdki
ucmbeshuu=uuhsebmcu
p=p
bpmfedo=odefmpb
fntahntbd=dbtnhatnf
yhavit=tivahy
r=r
nebrilndpg=gpdnlirben
iiuoi=iouii
cbmrwm=mwrmbc
aloavdbft=tfbdvaola
lcm=mcl
iqvjpr=rpjvqi
evfoy=yofve
bwormai=iamrowb
oega=ageo
cipbhsyc=cyshbpic
ehtux=xuthe
ksqvbvwqtw=wtqwvbvqsk
ahcilftf=ftflicha
ftjrx=xrjtf
g=g
bfg=gfb
nguwfbw=wbfwugn
nvcdtbxz=zxbtdcvn
nhfhizeuxw=wxuezihfhn
psjacu=ucajsp
rvrceywhmi=imhwyecrvr
qgwqd=dqwgq
qqi=iqq
v=v
iejxqssg=gssqxjei
qqy=yqq
tmg=gmt
oo=oo
ncmfjpt=tpjfmcn
sxy=yxs
epkithas=sahtikpe
bptggv=vggtpb
pkc=ckp
bkppd=dppkb
cvybklmw=wmlkbyvc
c=c
smxhghjgl=lgjhghxms
igacyiksj=jskiycagi
mhnp=pnhm
saqfro=orfqas
tqkxdhsrxe=exrshdxkqt
ywdbxwieck=kceiwxbdwy
sxiyj=jyixs
mcansqoxqr=rqxoqsnacm
qum=muq
lh=hl
ubvqg=gqvbu
op=po
k=k
sbfjwr=rwjfbs
lgz=zgl
uwwxtx=xtxwwu
fypil=lipyf
lfoluwig=giwulofl
e=e
bgbh=hbgb
xhibwzn=nzwbihx
dpzuzmkh=hkmzuzpd
nrpfjor=rojfprn
hlazqel=leqzalh
gjvaqdiimy=ymiidqavjg
p=p
seb=bes
vswwbprcyl=lycrpbwwsv
jjl=ljj
orhi=ihro
puoqhnwe=ewnhqoup
ljdgx=xgdjl
rjecac=cacejr
hp=ph
wzevkerdbl=lbdrekvezw
dkbi=ibkd
q=q
coysegih=higesyoc
j=j
ys=sy
mcqb=bqcm
qgdjnpg=gpnjdgq
uhu=uhu
wrlbit=tiblrw
avayx=xyava
asnadhz=zhdansa
god=dog
xxcxvwmap=pamwvxcxx
nxervmpuq=qupmvrexn
ibcrxzwz=zwzxrcbi
qo=oq
f=f
kuukav=vakuuk
zqx=xqz
soyu=uyos
qinho=ohniq
ypsiqvowrt=trwovqispy
mlkdoj=jodklm
xgxgjb=bjgxgx
otnyjtmht=thmtjynto
qwxqihhb=bhhiqxwq
qni=inq
vaw=wav
nzwa=awzn
uquzuoaa=aaouzuqu
sjhxzxtdpk=kpdtxzxhjs
sxyu=uyxs
boaov=voaob
rknoapea=aepaonkr
vcozqyjms=smjyqzocv
kmkxq=qxkmk
v=v
rpaobca=acboapr
xsqiuzni=inzuiqsx
gqoxzvc=cvzxoqg
ho=oh
emjsxj=jxsjme
jruiqegoo=oogeqiurj
pagsahqzf=fzqhasgap
dbd=dbd
whrhnv=vnhrhw
lidvd=dvdil
wq=qw
gaad=daag
smd=dms
ors=sro
tqrovguhp=phugvorqt
kos=sok
tbqmyc=cymqbt
tssfkgqs=sqgkfsst
qi=iq
mw=wm
w=w
xsa=asx
yfrrdoj=jodrrfy
wovtc=ctvow
cnnzvljpuj=jupjlvznnc
bneczfjvrs=srvjfzcenb
gczcz=zczcg
eyg=gye
raa=aar
heycjt=tjcyeh
piqfjrqvzr=rzvqrjfqip
if=fi
apao=oapa
soxudn=nduxos
giahimc=cmihaig
znr=rnz
nsit=tisn
znkyno=onyknz
uphmt=tmhpu
szbgzyszgi=igzsyzgbzs
ayavrwq=qwrvaya
wddgmi=imgddw
hjzf=fzjh
hakban=nabkah
jlwibfaob=boafbiwlj
cg=gc
mru=urm
pqmbsfctjd=djtcfsbmqp
kfbnjwrl=lrwjnbfk
wcjccuf=fuccjcw
nhw=whn
y=y
klt=tlk
tlirtyv=vytrilt
kw=wk
z=z
n=n
pjljdw=wdjljp
ogw=wgo
wfxidpkwm=mwkpdixfw
zeldlfzh=hzfldlez
expm=mpxe
e=e
qmnculgkls=slkglucnmq
mb=bm
o=o
kvq=qvk
veyqvnsi=isnvqyev
gcy=ycg
bwact=tcawb
wmuppwq=qwppumw
shgqbvu=uvbqghs
ugo=ogu
fdv=vdf
dfwolitadn=ndatilowfd
gc=cg
cgdrs=srdgc
slrdbwapc=cpawbdrls
kznfzjbs=sbjzfnzk
wam=maw
aot=toa
tawpcctr=rtccpwat
vjvpmcqkdi=idkqcmpvjv
uadfi=ifdau
tzm=mzt
loy=yol
baghkikbwc=cwbkikhgab
inxedb=bdexni
uernol=lonreu
tpmfljlm=mljlfmpt
wi=iw
qqfuqcnw=wncqufqq
wz=zw
eit=tie
hw=wh
a=a
ehbkso=oskbhe
dpzg=gzpd
prkv=vkrp
dnepnkqod=doqknpend
j=j
leyfes=sefyel
hdkjq=qjkdh
ny=yn
tkaocdbqs=sqbdcoakt
uohrw=wrhou
ooqlueuar=raueulqoo
rzkay=yakzr
sgnkvhvq=qvhvkngs
ruryyi=iyyrur
dhvqt=tqvhd
fkp=pkf
xooe=eoox
he=eh
wih=hiw
lltjqd=dqjtll
cyexwpidf=fdipwxeyc
qliyra=aryilq
wnpwpakbcv=vcbkapwpnw
sayu=uyas
tyqdsvrliw=wilrvsdqyt
otpka=akpto
ogku=ukgo
poxbenqqzo=ozqqnebxop
tmkuhcql=lqchukmt
nti=itn
xewn=nwex
osmh=hmso
lrotdpeyt=tyepdtorl
facxl=lxcaf
zaaukothn=nhtokuaaz
oaefiqjoa=aojqifeao
hsgnnjyoh=hoyjnngsh
zogyypm=mpyygoz
zheysouws=swuosyehz
etazzgj=jgzzate
sstm=mtss
pkavkfngoc=cognfkvakp
ukjo=ojku
rdovangno=ongnavodr
fmmo=ommf
vynzpjeawg=gwaejpznyv
sxbhun=nuhbxs
yihtclr=rlcthiy
yb=by
sowxvgfl=lfgvxwos
cz=zc
yykuhf=fhukyy
ub=bu
zso=osz
yrtwcwyewi=iweywcwtry
dqmqpibscx=xcsbipqmqd
qmzjysihgw=wghisyjzmq
o=o
eethxyrx=xryxhtee
tlgrs=srglt
dubmyz=zymbud
sodovw=wvodos
hhzflazzlw=wlzzalfzhh
lzksp=pskzl
d=d
znjy=yjnz
usbvu=uvbsu
elykc=ckyle
badm=mdab
rkcyoe=eoyckr
q=q
ctek=ketc
jzotzbtwn=nwtbztozj
hjgxpdnvf=fvndpxgjh
gtbsehb=bhesbtg
tmstzwpuw=wupwztsmt
adsgd=dgsda
wlesfdchm=mhcdfselw
nhakdze=ezdkahn
giub=buig
yhqtjm=mjtqhy
efuhinqq=qqnihufe
hpxeeunwkz=zkwnueexph
lhh=hhl
emwu=uwme
p=p
rdlxgkuy=yukgxldr
afredjkmup=pumkjderfa
tqlnt=tnlqt
qucy=ycuq
krw=wrk
abspekcl=lckepsba
zmbrf=frbmz
i=i
hhmoltrksy=yskrtlomhh
jbepu=upebj
xazgavclmv=vmlcvagzax
guidyygbsv=vsbgyydiug
rkkciufo=ofuickkr
eq=qe
q=q
wgs=sgw
o=o
jqpmvubyd=dybuvmpqj
svdlxtqa=aqtxldvs
qihpdzbj=jbzdphiq
wbmds=sdmbw
wz=zw
gxy=yxg
sqmnquv=vuqnmqs
bknrctew=wetcrnkb
oqm=mqo
rqhcxzj=jzxchqr
xpze=ezpx
zbexc=cxebz
cagcrivmse=esmvircgac
iumvbrah=harbvmui
rdik=kidr
xzxfuoazw=wzaoufxzx
jykktnxo=oxntkkyj
rqtqzpknvj=jvnkpzqtqr
oclhbmvkfu=ufkvmbhlco
eje=eje
wgwyxt=txywgw
scmsffeynk=knyeffsmcs
iuedejlwpe=epwljedeui
hqamdfvpn=npvfdmaqh
vihejij=jijehiv
iozfdm=mdfzoi
qxgebeoqqy=yqqoebegxq
mygtmue=eumtgym
lva=avl
cqwyztnnnm=mnnntzywqc
hfnlgj=jglnfh
vv=vv
qlbifdm=mdfiblq
rhufi=ifuhr
ol=lo
pehp=phep
rgorsl=lsrogr
koc=cok
hguiwmp=pmwiugh
njhdxrr=rrxdhjn
ryunda=adnuyr
ijlsr=rslji
csqynz=znyqsc
insen=nesni
hglrn=nrlgh
tuuqwjzzu=uzzjwquut
v=v
dsol=losd
qz=zq
t=t
k=k
kpeavzs=szvaepk
klelnba=abnlelk
goiyos=soyiog
szlhjf=fjhlzs
anoswrwgv=vgwrwsona
vi=iv
jfvrceabf=fbaecrvfj
pgfvm=mvfgp
bra=arb
ydvsrejji=ijjersvdy
kzu=uzk
djebskbv=vbksbejd
xd=dx
kcvstuxxai=iaxxutsvck
tgktszvst=tsvzstkgt
xeorwzbvhi=ihvbzwroex
ifblldm=mdllbfi
vwy=ywv
emnrpgws=swgprnme
r=r
tnsedxnk=knxdesnt
nlkvuhsdvj=jvdshuvkln
zrrdmoikw=wkiomdrrz
wrrbykxya=ayxkybrrw
zujt=tjuz
jlobkgo=ogkbolj
kajiktwqk=kqwtkijak
qdysajhw=whjasydq
kwjmjskj=jksjmjwk
r=r
dbxv=vxbd
kv=vk
bje=ejb
vwpzymrcm=mcrmyzpwv
lsd=dsl
f=f
ebgveul=luevgbe
elux=xule
jmn=nmj
icf=fci
un=nu
ysxbdejdqe=eqdjedbxsy
kxcvtavezj=jzevatvcxk
odjefx=xfejdo
kt=tk
skxuhjgyg=gygjhuxks
fzlpfp=pfplzf
txheqtdgxq=qxgdtqehxt
mtcf=fctm
docrjo=ojrcod
xamyreu=uerymax
e=e
nn=nn
z=z
lpqerei=iereqpl
mejenfjc=cjfnejem
wc=cw
jdznnqzd=dzqnnzdj
ad=da
fy=yf
mizmeegzm=mzgeemzim
xboszvtuk=kutvzsobx
qahu=uhaq
fqhzvq=qvzhqf
ziqsmfqh=hqfmsqiz
bvhfwzo=ozwfhvb
jdzlibz=zbilzdj
qfhawbjubh=hbujbwahfq
xytsy=ystyx
boultgmsen=nesmgtluob
gggaajr=rjaaggg
zfdpugnlse=eslngupdfz
wkubc=cbukw
mnv=vnm
qjh=hjq
ltewawubml=lmbuwawetl
sciqssfuh=hufssqics
dsprqj=jqrpsd
g=g
wrsbovy=yvobsrw
upa=apu
djrvchqvhk=khvqhcvrjd
sapslhhp=phhlspas
yvcxtvgvbb=bbvgvtxcvy
vtnmbdidw=wdidbmntv
jbh=hbj
lwmhbl=lbhmwl
oxbffib=biffbxo
osfalm=mlafso
dgbruiteed=deetiurbgd
vzmp=pmzv
cqctejror=rorjetcqc
mplwldyy=yydlwlpm
vjqxjxzxx=xxzxjxqjv
taixyatzf=fztayxiat
rbhq=qhbr
oocxsv=vsxcoo
crgancekoh=hokecnagrc
cjpr=rpjc
ecteevlgoi=ioglveetce
n=n
axglmgoe=eogmlgxa
cwfsn=nsfwc
orj=jro
ivdxn=nxdvi
kqouuz=zuuoqk
hkjdrkse=eskrdjkh
gf=fg
ddi=idd
mtltgxdf=fdxgtltm
mynmjmgqhx=xhqgmjmnym
qgmv=vmgq
sd=ds
jeqnexa=axenqej
mpcdt=tdcpm
bvjlwh=hwljvb
i=i
s=s
zpijlnw=wnljipz
eohmyngvw=wvgnymhoe
nnb=bnn
isjcccw=wcccjsi
ugknxrspte=etpsrxnkgu
smowdjgrob=borgjdwoms
kow=wok
kpjuivc=cviujpk
dweivdhbz=zbhdviewd
h=h
dokkdc=cdkkod
dgxdjuviv=vivujdxgd
pekfx=xfkep
l=l
gdds=sddg
ndnkk=kkndn
tf=ft
zvwahq=qhawvz
aadxe=exdaa
kgerugc=cguregk
acuyazato=otazayuca
gomhb=bhmog
adbraikcl=lckiarbda
xhxhpnwz=zwnphxhx
vuixxchq=qhcxxiuv
nonb=bnon
z=z
zwq=qwz
bm=mb
a=a
yjmvclx=xlcvmjy
quplyb=bylpuq
nthflxxfwu=uwfxxlfhtn
fzpflvifmc=cmfivlfpzf
hiyydxlzap=pazlxdyyih
fsaqptgr=rgtpqasf
al=la
gxyrdov=vodryxg
oz=zo
udljynhit=tihnyjldu
vpnhql=lqhnpv
bc=cb
syqzwfexro=orxefwzqys
qtisbybgzy=yzgbybsitq
cnhv=vhnc
zop=poz
qvpssvebpw=wpbevsspvq
vhalgfka=akfglahv
hifdevf=fvedfih
ysllfnpuby=ybupnfllsy
vhwb=bwhv
q=q
y=y
tatduqxqmd=dmqxqudtat
ay=ya
dkvgsino=onisgvkd
ifjv=vjfi
ljcrmcjog=gojcmrcjl
aaorckfhvw=wvhfkcroaa
s=s
yaosb=bsoay
zrlzyl=lyzlrz
lgzml=lmzgl
osam=maso
xesfqx=xqfsex
avaq=qava
ryrsylz=zlysryr
qegbp=pbgeq
wgengvtzum=muztvgnegw
vqt=tqv
gfwxzh=hzxwfg
jrbfdl=ldfbrj
ob=bo
lvao=oavl
i=i
pafxsjaw=wajsxfap
lp=pl
t=t
tdpcgi=igcpdt
mmddq=qddmm
eqpinrrkh=hkrrnipqe
prwgraqb=bqargwrp
xeul=luex
r=r
gklwqmlo=olmqwlkg
igqyv=vyqgi
lfd=dfl
k=k
gfymq=qmyfg
upfc=cfpu
lna=anl
vwsbekr=rkebswv
pdrkrjlmjs=sjmljrkrdp
lzozh=hzozl
pq=qp
iczyra=aryzci
nn=nn
n=n
hieak=kaeih
qb=bq
zkqzxv=vxzqkz
e=e
wfwebp=pbewfw
uxvb=bvxu
quwsbysms=smsybswuq
tu=ut
lce=ecl
nr=rn
gxfzu=uzfxg
zkxbmhh=hhmbxkz
yrit=tiry
m=m
nv=vn
reng=gner
leldm=mdlel
sdzbbvkwqe=eqwkvbbzds
yc=cy
sryzhsgljr=rjlgshzyrs
zfu=ufz
cxxawsiddo=oddiswaxxc
ebbq=qbbe
rxnd=dnxr
zrnwxenzaj=jaznexwnrz
owkt=tkwo
ftzcsextjq=qjtxescztf
glejseb=besjelg
wcw=wcw
fkkzfajt=tjafzkkf
zszc=czsz
clp=plc
qutxhjx=xjhxtuq
umngzqvo=ovqzgnmu
cgkqhfby=ybfhqkgc
bnsmbfp=pfbmsnb
ml=lm
jpeqwp=pwqepj
gwovhazvmp=pmvzahvowg
hxpxcewv=vwecxpxh
tii=iit
umxlgrvh=hvrglxmu
uaprqvr=rvqrpau
wytuaxhp=phxautyw
iul=lui
of=fo
kokc=ckok
cfyepok=kopeyfc
zdewp=pwedz
ygrzaxpai=iapxazrgy
cfetzsyuhw=whuysztefc
w=w
ajqwjaixs=sxiajwqja
wvrqlnqmu=umqnlqrvw
h=h
n=n
migmq=qmgim
cbozzt=tzzobc
heles=seleh
yfems=smefy
hrfrss=ssrfrh
m=m
eron=nore
wapja=ajpaw
hvjkmi=imkjvh
uewlimvkps=spkvmilweu
axzjnpd=dpnjzxa
ea=ae
lqhilh=hlihql
c=c
cxbm=mbxc
wwytron=nortyww
hzpk=kpzh
r=r
ffiwkevwq=qwvekwiff
jbv=vbj
vlnin=ninlv
s=s
rgqzccsdb=bdscczqgr
zap=paz
pwdptn=ntpdwp
r=r
wgzghq=qhgzgw
nxdeblq=qlbedxn
zr=rz
lvffravf=fvarffvl
spkuehucvo=ovcuheukps
ysq=qsy
hpzkzp=pzkzph
kvyg=gyvk
iidwzqfsxk=kxsfqzwdii
ffbvzzwbf=fbwzzvbff
ksjqjqvi=ivqjqjsk
pbez=zebp
cyhu=uhyc
k=k
dfxwspi=ipswxfd
hrdiodzxw=wxzdoidrh
okbofnax=xanfobko
leygj=jgyel
oaqwnjc=cjnwqao
oblrujhqy=yqhjurlbo
kteptls=sltpetk
qz=zq
dphugs=sguhpd
f=f
dlskloevz=zveolksld
mql=lqm
jvtthfscf=fcsfhttvj
np=pn
s=s
jzvg=gvzj
hagemgalng=gnlagmegah
frrwftrj=jrtfwrrf
iarvfvp=pvfvrai
cxayjdqi=iqdjyaxc
tyage=egayt
zqb=bqz
elwds=sdwle
uzmdhpa=aphdmzu
odlloje=ejolldo
ed=de
yn=ny
qdohhpetrc=crtephhodq
r=r
ofdsfon=nofsdfo
vyse=esyv
h=h
xzxw=wxzx
zvwcfmcdle=eldcmfcwvz
ljypmhbby=ybbhmpyjl
pz=zp
yqwtynyq=qynytwqy
pnct=tcnp
ef=fe
es=se
mann=nnam
b=b
xqp=pqx
xiz=zix
g=g
gifrc=crfig
zyjxbbskbh=hbksbbxjyz
xqcbje=ejbcqx
jxpxuv=vuxpxj
cchdstzo=oztsdhcc
dwdfod=dofdwd
ngbgaujz=zjuagbgn
doxirxmq=qmxrixod
la=al
tqr=rqt
fqqpoeri=ireopqqf
xosipwyytn=ntyywpisox
zwjfb=bfjwz
ik=ki
ecf=fce
qilnqo=oqnliq
qkjptpe=eptpjkq
su=us
eczcvdmb=bmdvczce
vifubeftp=ptfebufiv
ucxuasc=csauxcu
grcbeesw=wseebcrg
viyatgd=dgtayiv
qeijuxcnf=fncxujieq
hm=mh
u=u
qjxaydy=ydyaxjq
ncqsbxlian=nailxbsqcn
cuq=quc
apn=npa
fhxnmved=devmnxhf
radnt=tndar
endpc=cpdne
webo=obew
yb=by
gunw=wnug
laqzohxcwn=nwcxhozqal
gncqhknytv=vtynkhqcng
zshaokaf=fakoahsz
zrtbmclgm=mglcmbtrz
iopsyocgur=rugcoyspoi
mj=jm
cnct=tcnc
dhed=dehd
tlpembskic=ciksbmeplt
snzariyzpg=gpzyirazns
tbdb=bdbt
k=k
fmhqrzjsr=rsjzrqhmf
hhuvmbpvxc=cxvpbmvuhh
nk=kn
lssozgzey=yezgzossl
bwsdmmsgm=mgsmmdswb
uufvnnwmus=sumwnnvfuu
vojjjm=mjjjov
nfkbuzaqhp=phqazubkfn
cvdx=xdvc
dzypep=pepyzd
jmqikafut=tufakiqmj
o=o
asupyangj=jgnaypusa
bszphtbm=mbthpzsb
fnrda=adrnf
jfeauj=juaefj
vcuygg=ggyucv
eaviwd=dwivae
gyxe=exyg
npurddfkkw=wkkfddrupn
lxv=vxl
skjcb=bcjks
zwj=jwz
omiyexmey=yemxeyimo
zzkvv=vvkzz
gvzmwbo=obwmzvg
ow=wo
uar=rau
ale=ela
vjwjb=bjwjv
vpdmwrxvai=iavxrwmdpv
yhiptnmm=mmntpihy
sxs=sxs
wsyuyc=cyuysw
biovzw=wzvoib
y=y
latwvfntfu=uftnfvwtal
curom=moruc
dpcopmaayr=ryaampocpd
xmiyvlm=mlvyimx
exx=xxe
divzoicn=nciozvid
g=g
jfzfgadw=wdagfzfj
roncnly=ylncnor
ydwss=sswdy
xpeuvd=dvuepx
r=r
ltdlfiw=wifldtl
auymkpsdt=tdspkmyua
aigcfhzu=uzhfcgia
cmxyhqsa=asqhyxmc
zbulmil=limlubz
aaskppd=dppksaa
lpigqrklb=blkrqgipl
unqh=hqnu
blohtr=rtholb
kkwuhjzeuq=quezjhuwkk
kbwflpkcnq=qnckplfwbk
ejsvjo=ojvsje
hjfqvmqu=uqmvqfjh
hm=mh
hiuvvadbjn=njbdavvuih
ryiptn=ntpiyr
tguc=cugt
ubvmh=hmvbu
pffvx=xvffp
hye=eyh
sstcedbss=ssbdectss
utod=dotu
hjdezan=nazedjh
zvlkfigj=jgifklvz
ymh=hmy
epeh=hepe
rqqaoesqzo=ozqseoaqqr
wonjfcon=nocfjnow
symgij=jigmys
qbyfcvvus=suvvcfybq
vhtdfaqv=vqafdthv
t=t
ltnzeltld=dltlezntl
sqgcc=ccgqs
zwz=zwz
szlrccsqew=weqsccrlzs
lfzxk=kxzfl
mame=emam
aoqq=qqoa
gdlglcrj=jrclgldg
qvfljlbzi=izbljlfvq
wt=tw
mj=jm
ojngvpki=ikpvgnjo
czwrtgkont=tnokgtrwzc
ovzs=szvo
fbmyrtv=vtrymbf
ynucrtjwh=hwjtrcuny
sajtunr=rnutjas
dgrmk=kmrgd
w=w
wxlfysl=lsyflxw
vzdeqm=mqedzv
endacanmxl=lxmnacadne
ijhm=mhji
wprkt=tkrpw
botbdhm=mhdbtob
jdzo=ozdj
eqhqzy=yzqhqe
kk=kk
tjilrpcf=fcprlijt
cmaapu=upaamc
x=x
lbl=lbl
tk=kt
pailr=rliap
vxlpibx=xbiplxv
nq=qn
ibniza=azinbi
gxn=nxg
cvftd=dtfvc
dgowfoyag=gayofwogd
ukdxr=rxdku
clemkmm=mmkmelc
jvsxsubx=xbusxsvj
gujifbnk=knbfijug
ixetgax=xagtexi
rafmlmqw=wqmlmfar
dks=skd
pfowuls=sluwofp
fh=hf
fy=yf
wlhkxaggf=fggaxkhlw
lhmuernli=ilnreumhl
har=rah
hplatexyd=dyxetalph
vhj=jhv
vw=wv
y=y
pca=acp
qiqnvud=duvnqiq
qb=bq
ubvrjk=kjrvbu
mynxbszfc=cfzsbxnym
eozvtamhab=bahmatvzoe
xjpqxmsy=ysmxqpjx
hjcyzqaak=kaaqzycjh
ue=eu
tcnpi=ipnct
pp=pp
zfkimdka=akdmikfz
i=i
j=j
lxykzgyuc=cuygzkyxl
nzpmqnmbb=bbmnqmpzn
fzwnc=cnwzf
qy=yq
mfqiohmmj=jmmhoiqfm
h=h
cfscvggpng=gnpggvcsfc
cmdev=vedmc
yjsudrdohb=bhodrdusjy
dl=ld
gdd=ddg
uobif=fibou
u=u
q=q
jfrgavt=tvagrfj
lugmdnljk=kjlndmgul
syyefxsmd=dmsxfeyys
kjyn=nyjk
ip=pi
d=d
ripwdd=ddwpir
ya=ay
vdikks=skkidv
ciaefzth=htzfeaic
y=y
xkmrxijmbx=xbmjixrmkx
rgf=fgr
thwhz=zhwht
kpxj=jxpk
jnbzeiy=yiezbnj
nqtfaoryoy=yoyroaftqn
luenosfb=bfsoneul
fhpv=vphf
naiwdso=osdwian
jobnbmak=kambnboj
ucrdz=zdrcu
ky=yk
v=v
yyhf=fhyy
ziexql=lqxeiz
puqpvoiu=uiovpqup
bwexzuxl=lxuzxewb
u=u
npka=akpn
b=b
jhzr=rzhj
oovdp=pdvoo
pghsldad=dadlshgp
bohsjezjus=sujzejshob
wicmtlekb=bkeltmciw
ioocn=ncooi
zstsftr=rtfstsz
pbunfc=cfnubp
byodwlgid=diglwdoyb
tdsxyf=fyxsdt
bwtzri=irztwb
ov=vo
lbrgafr=rfagrbl
ilmfuplvwy=ywvlpufmli
ckuzf=fzukc
opvdcmtlk=kltmcdvpo
avffe=effva
epgthyca=acyhtgpe
cywx=xwyc
xhtdmzw=wzmdthx
ywfct=tcfwy
kerwynizr=rzinywrek
ilkqp=pqkli
qwvqr=rqvwq
vwmnvgm=mgvnmwv
gaue=euag
onavb=bvano
ejvrib=birvje
dyzroauboj=jobuaorzyd
krqjkzrryb=byrrzkjqrk
luch=hcul
mukb=bkum
uajvjq=qjvjau
weh=hew
sxypq=qpyxs
efn=nfe
repkjvczfi=ifzcvjkper
ipcwefbflk=klfbfewcpi
rksro=orskr
stjb=bjts
jbvgjtc=ctjgvbj
igfa=afgi
psvrml=lmrvsp
djxubvvq=qvvbuxjd
htctpv=vptcth
eoxobdjeaf=faejdboxoe
njto=otjn
epwueihe=ehieuwpe
gmcwdcb=bcdwcmg
vlqxmw=wmxqlv
xjwx=xwjx
weddqrxef=fexrqddew
sxt=txs
diup=puid
m=m
gus=sug
umqgewnl=lnwegqmu
ovjiqfubyn=nybufqijvo
vboownoqil=liqonwoobv
exznyulh=hluynzxe
ozstnoqhs=shqontszo
cj=jc
j=j
krrbw=wbrrk
bznk=knzb
jmimab=bamimj
xrjvl=lvjrx
eyih=hiye
vnv=vnv
zhbsg=gsbhz
egnajb=bjange
vm=mv
v=v
luwabadyn=nydabawul
fgxabap=pabaxgf
j=j
g=g
apn=npa
zaizzgecl=lcegzziaz
m=m
ab=ba
oi=io
dxvue=euvxd
rjzbzu=uzbzjr
egqkjwbe=ebwjkqge
kiumilt=tlimuik
zel=lez
wjhptyn=nytphjw
lfsuie=eiusfl
diaarrclbw=wblcrraaid
zj=jz
g=g
iqu=uqi
dloslvbqlm=mlqbvlsold
jpje=ejpj
nkpsrcpz=zpcrspkn
paqgj=jgqap
okrv=vrko
yrtuzugdqx=xqdguzutry
wznwj=jwnzw
oguvx=xvugo
c=c
tkaat=taakt
gsigihk=khigisg
c=c
szfgvexo=oxevgfzs
mvlnsdo=odsnlvm
zefsnrb=brnsfez
nupstzj=jztspun
z=z
kauewsoko=okosweuak
ehak=kahe
uotvt=tvtou
fcfxjyvape=epavyjxfcf
zxj=jxz
c=c
xaizzybd=dbyzziax
wnxh=hxnw
stboroazi=izaorobts
nxv=vxn
cgyepfzzx=xzzfpeygc
rdspxqrsmz=zmsrqxpsdr
jydabydhh=hhdybadyj
m=m
xffbjhs=shjbffx
pavfzjqimz=zmiqjzfvap
dhnxuvbp=pbvuxnhd
m=m
uiuvfsn=nsfvuiu
otdygwps=spwgydto
odvpcstag=gatscpvdo
npwjmrduu=uudrmjwpn
vt=tv
rfolg=glofr
mibr=rbim
wjmxkitlk=kltikxmjw
bcqqd=dqqcb
sfcagcysif=fisycgacfs
iko=oki
xqvvkjidy=ydijkvvqx
udsujwex=xewjusdu
wde=edw
fmkpo=opkmf
cdzajrqnhx=xhnqrjazdc
ydkx=xkdy
regbgxw=wxgbger
o=o
wp=pw
mlozwxiz=zixwzolm
g=g
gmsgj=jgsmg
woebn=nbeow
qghda=adhgq
ssxfcikdt=tdkicfxss
rrswfyfl=lfyfwsrr
ftooujcx=xcjuootf
bbcgudtmb=bmtdugcbb
avhbeansqn=nqsnaebhva
dylwiqs=sqiwlyd
bjrgvmhcd=dchmvgrjb
jcryxcjd=djcxyrcj
gzakeym=myekazg
lmgo=ogml
oclfava=avaflco
yefttquq=quqttfey
enfyjje=ejjyfne
hbuckmk=kmkcubh
ntykh=hkytn
svirkshv=vhskrivs
tamug=gumat
oy=yo
zkah=hakz
debqeltft=tftleqbed
wfknuid=diunkfw
qoyekn=nkeyoq
kmnuk=kunmk
pgxcpvwi=iwvpcxgp
nzgwknyp=pynkwgzn
mctbwdrri=irrdwbtcm
mjb=bjm
oyclqrsl=lsrqlcyo
ale=ela
fxqod=doqxf
rexubce=ecbuxer
ldon=nodl
jqbflricq=qcirlfbqj
xgusxisw=wsixsugx
bmyxuyeo=oeyuxymb
rgye=eygr
kbmux=xumbk
ewuvvmmn=nmmvvuwe
qzsyl=lyszq
gchavfe=efvahcg
i=i
xpky=ykpx
mnxgm=mgxnm
veoblw=wlboev
tyoxoym=myoxoyt
bdq=qdb
felwogmnx=xnmgowlef
xgt=tgx
loiniaomim=mimoainiol
dwoifdjt=tjdfiowd
foeekyqpdq=qdpqykeeof
kvobcxb=bxcbovk
szvbhsuz=zushbvzs
xbcs=scbx
fprbssow=wossbrpf
w=w
bloki=ikolb
fhrakwtb=btwkarhf
rlf=flr
uumbten=netbmuu
ogh=hgo
bpeinayw=wyaniepb
kcbjsrdqj=jqdrsjbck
mwoowra=arwoowm
fkbxcc=ccxbkf
bgkim=mikgb
wdynrxgkno=onkgxrnydw
oyrxaeqyfp=pfyqeaxryo
ey=ye
kzplpxgogw=wgogxplpzk
olsshdvvo=ovvdhsslo
s=s
eawdfh=hfdwae
zcequfk=kfuqecz
fvwd=dwvf
pwdrm=mrdwp
vqedpkq=qkpdeqv
chef=fehc
ofyjkymlj=jlmykjyfo
fieusibzve=evzbisueif
bpo=opb
dewsiecd=dceiswed
u=u
wbjlsa=asljbw
x=x
uehkkr=rkkheu
acmfo=ofmca
fwedgiog=goigdewf
hrmgifvx=xvfigmrh
owsxv=vxswo
vknku=uknkv
oiokj=jkoio
zkd=dkz
nldcruhumv=vmuhurcdln
vwvowxieb=beixwovwv
hud=duh
l=l
njx=xjn
ci=ic
rdomb=bmodr
merax=xarem
nyk=kyn
xcmer=remcx
mqtxrgvim=mivgrxtqm
ixsgxfq=qfxgsxi
fzcogeusa=asuegoczf
burnnu=unnrub
maai=iaam
fkfoj=jofkf
timvoscwcf=fcwcsovmit
lz=zl
awbhun=nuhbwa
q=q
rrckbs=sbkcrr
vvweqmgkq=qkgmqewvv
cxqpetq=qtepqxc
ookpakyypi=ipyykapkoo
wpn=npw
yeovbi=ibvoey
hblwtwtai=iatwtwlbh
meked=dekem
kgmccvjkj=jkjvccmgk
esxfngf=fgnfxse
izdmogex=xegomdzi
pj=jp
euhxxv=vxxhue
cybv=vbyc
t=t
uhdo=odhu
jtfzgbjmb=bmjbgzftj
djlziyzh=hzyizljd
mjflnbbnh=hnbbnlfjm
rocujgrrs=srrgjucor
wzchaotbh=hbtoahczw
dxsffvdu=udvffsxd
mua=aum
lrbyjfivnq=qnvifjybrl
nkacb=bcakn
c=c
tcps=spct
omgkcsngt=tgnsckgmo
acyl=lyca
ecpp=ppce
do=od
tp=pt
ukegwwjnd=dnjwwgeku
bihxx=xxhib
kazsjjy=yjjszak
xbweh=hewbx
rs=sr
h=h
bbvcqyast=tsayqcvbb
ugujkx=xkjugu
lcxq=qxcl
kueuh=hueuk
mjjauxd=dxuajjm
jvhlntxx=xxtnlhvj
o=o
cbzngvfw=wfvgnzbc
oulseot=toesluo
cjkzouab=bauozkjc
b=b
wmfynj=jnyfmw
qowtncgc=cgcntwoq
jsabfgr=rgfbasj
vobb=bbov
r=r
ovcjrzhsp=pshzrjcvo
kxib=bixk
qqorvkjzd=dzjkvroqq
idud=dudi
ho=oh
ye=ey
rdvh=hvdr
rtvbcw=wcbvtr
thljiuhe=ehuijlht
ssyqcskt=tkscqyss
hbckowy=ywokcbh
wlew=welw
fpiwvahmmi=immhavwipf
rrd=drr
olngfyykc=ckyyfgnlo
lsw=wsl
o=o
oabzcykd=dkyczbao
xmlkngwkk=kkwgnklmx
w=w
rtkrlag=galrktr
obnhkzaln=nlazkhnbo
nlfqa=aqfln
inac=cani
uyrbqssn=nssqbryu
wzjg=gjzw
lnqqwgq=qgwqqnl
scgpmtu=utmpgcs
szmej=jemzs
gxfvvoqjuy=yujqovvfxg
cljo=ojlc
ropn=npor
wth=htw
salkc=cklas
gyvzngiq=qignzvyg
skt=tks
igvvl=lvvgi
kwhd=dhwk
uid=diu
m=m
lccicxcwx=xwcxciccl
pxnq=qnxp
keldoruws=swurodlek
uvdqz=zqdvu
juherskv=vksrehuj
fmgr=rgmf
ynrnqwr=rwqnrny
gylj=jlyg
qlx=xlq
zsjvxinca=acnixvjsz
qkw=wkq
x=x
eygjn=njgye
kcvqto=otqvck
eegola=alogee
wqbdj=jdbqw
gxilithwhd=dhwhtilixg
rqtfytmvr=rvmtyftqr
spyzhnep=penhzyps
ixqgupmzx=xzmpugqxi
kteghyjg=gjyhgetk
qgtifmle=elmfitgq
swtqzgbo=obgzqtws
louthebqxf=fxqbehtuol
yditmlcufd=dfuclmtidy
iqnn=nnqi
atnytyh=hytynta
ef=fe
jch=hcj
h=h
nohrbsvy=yvsbrhon
dyuaztpkje=ejkptzauyd
z=z
jzsw=wszj
kdmauaerh=hreauamdk
pkrnmtosr=rsotmnrkp
myu=uym
pszbhp=phbzsp
ystfziwhtt=tthwizftsy
qgp=pgq
wvldx=xdlvw
atakc=ckata
ydtxovoo=oovoxtdy
i=i
tghby=ybhgt
yc=cy
oujeduigzk=kzgiudejuo
duhouir=riuohud
qxqiamk=kmaiqxq
higyg=gygih
pnclulsrjh=hjrslulcnp
ow=wo
pvganv=vnagvp
sde=eds
iiuxnytki=iktynxuii
sqeaygpjy=yjpgyaeqs
cy=yc
gycshbyqb=bqybhscyg
laovppbma=ambppvoal
hmmlxfbwy=ywbfxlmmh
iobyp=pyboi
wl=lw
mi=im
migczglvtf=ftvlgzcgim
lqptpcd=dcptpql
yrfrvnac=canvrfry
pxtwkhvp=pvhkwtxp
tjzn=nzjt
yrblc=clbry
pxpphz=zhppxp
xfoqymqq=qqmyqofx
lae=eal
avnzgal=lagznva
lrwktawpt=tpwatkwrl
qbbeeth=hteebbq
kygonfk=kfnogyk
zbdvtzfcm=mcfztvdbz
vszggjlnl=lnljggzsv
s=s
e=e
dkk=kkd
d=d
kjigmaim=miamgijk
hqmm=mmqh
venzlvelv=vlevlznev
crqfurst=tsrufqrc
crl=lrc
ju=uj
tpnevbg=gbvenpt
kyrafezq=qzefaryk
q=q
wqmxiamv=vmaixmqw
wyqvzy=yzvqyw
fzgajyxa=axyjagzf
obfsesdhw=whdsesfbo
zbwwqvl=lvqwwbz
qaz=zaq
zyigoywt=twyogiyz
n=n
bqk=kqb
bdzka=akzdb
jzvhc=chvzj
khspnyf=fynpshk
rc=cr
sgib=bigs
hfmbjf=fjbmfh
f=f
pvdximxi=ixmixdvp
t=t
h=h
javjrp=prjvaj
yspbv=vbpsy
blmpdzx=xzdpmlb
zusbonyggw=wggynobsuz
cjmfpxe=expfmjc
owlfzdwhgt=tghwdzflwo
qv=vq
no=on
snudwflwzc=czwlfwduns
rqvqfkrxre=erxrkfqvqr
ygcjqzjsty=ytsjzqjcgy
lywwqqbc=cbqqwwyl
lcdaqtu=utqadcl
vblus=sulbv
efgv=vgfe
ahzupbi=ibpuzha
xuqpmpwrct=tcrwpmpqux
ngcduygvw=wvgyudcgn
jtwzioh=hoizwtj
mwrree=eerrwm
wameujqbm=mbqjuemaw
ccdiuu=uuidcc
tpgvkm=mkvgpt
gamwmq=qmwmag
uabyvbq=qbvybau
qdvl=lvdq
jv=vj
stnbrb=brbnts
fzvs=svzf
sycexn=nxecys
aghgyp=pyghga
kj=jk
oxz=zxo
qtrvj=jvrtq
a=a
jcrmtadkff=ffkdatmrcj
ytch=hcty
gngptkc=cktpgng
zizmop=pomziz
t=t
zwwbdejwmi=imwjedbwwz
muvwuiier=reiiuwvum
cngfo=ofgnc
kiwfykhdyy=yydhkyfwik
mbgpgx=xgpgbm
bwcasx=xsacwb
nnvitsq=qstivnn
bwzsagjx=xjgaszwb
cjxkqwml=lmwqkxjc
ukk=kku
nradvsyt=tysvdarn
vxqnshzq=qzhsnqxv
qseyr=ryesq
wfgrutstig=gitsturgfw
juicpl=lpciuj
e=e
nw=wn
dit=tid
a=a
gt=tg
to=ot
gnhh=hhng
aef=fea
hsxwdvyrw=wryvdwxsh
kwisq=qsiwk
dgdhlmugs=sgumlhdgd
taxoq=qoxat
hkcz=zckh
x=x
imz=zmi
epelommv=vmmolepe
mcrm=mrcm
ydftxvwop=powvxtfdy
czaqjx=xjqazc
yrvzt=tzvry
igfid=difgi
ffmlz=zlmff
dihplndp=pdnlphid
yb=by
vwtzsqpho=ohpqsztwv
aeygqv=vqgyea
qdvfoclvxy=yxvlcofvdq
psfig=gifsp
jj=jj
gawixz=zxiwag
qwxltiwqf=fqwitlxwq
jrfs=sfrj
frn=nrf
jxn=nxj
abd=dba
fpyvh=hvypf
yoefjlzi=izljfeoy
sypixjdgw=wgdjxipys
micsjcboi=iobcjscim
go=og
g=g
pordro=ordrop
hfch=hcfh
aojalefuc=cufelajoa
gcueaq=qaeucg
drihngrzu=uzrgnhird
ybyfnh=hnfyby
wiqg=gqiw
ykq=qky
jqw=wqj
izhn=nhzi
vs=sv
ojxm=mxjo
ssyux=xuyss
hxgnbnoy=yonbngxh
aun=nua
pvi=ivp
ufwagmsv=vsmgawfu
dljxfqkang=gnakqfxjld
trt=trt
ffrxzymlx=xlmyzxrff
kfjvjqfnqy=yqnfqjvjfk
smoepc=cpeoms
xamtefdy=ydfetmax
aqyww=wwyqa
iq=qi
vrs=srv
bumkujhws=swhjukmub
iwbepja=ajpebwi
pwhhg=ghhwp
jsnbcuhzly=ylzhucbnsj
srhzmdojf=fjodmzhrs
e=e
tfg=gft
ot=to
dyzxghd=dhgxzyd
r=r
vngqe=eqgnv
rqswmwokn=nkowmwsqr
jekdedlw=wldedkej
sucv=vcus
m=m
f=f
sykwmx=xmwkys
edgt=tgde
zaxa=axaz
yq=qy
mytqjqa=aqjqtym
cjbkvlgwnf=fnwglvkbjc
nstdp=pdtsn
qqsotmt=tmtosqq
ccxm=mxcc
txrgvis=sivgrxt
jswi=iwsj
jasxzpk=kpzxsaj
jv=vj
scvgoakrq=qrkaogvcs
pj=jp
vesnz=znsev
fxwy=ywxf
h=h
cillu=ullic
dkpfi=ifpkd
tn=nt
ryuhdcfaql=lqafcdhuyr
ykkp=pkky
jgxde=edxgj
lotq=qtol
ltejbm=mbjetl
vuq=quv
rnn=nnr
qs=sq
bqehahhfnk=knfhhaheqb
z=z
gnma=amng
o=o
htg=gth
ainprtu=utrpnia
munwtgh=hgtwnum
ymjtpwzqad=daqzwptjmy
epalstnp=pntslape
gfdkij=jikdfg
kn=nk
uoeiobjn=njboieou
zxod=doxz
spvjwnsh=hsnwjvps
dxeay=yaexd
ekh=hke
ysdjygdy=ydgyjdsy
wd=dw
k=k
bh=hb
igrxsedo=odesxrgi
ocn=nco
f=f
bqqcsz=zscqqb
re=er
ynu=uny
qnwihew=wehiwnq
run=nur
madqnwlu=ulwnqdam
yocutqlfal=laflqtucoy
m=m
vzdwspo=opswdzv
evpmgvpqu=uqpvgmpve
cqr=rqc
pfmarzd=dzramfp
ekdirpyu=uypridke
ps=sp
s=s
uxtybklxyg=gyxlkbytxu
ye=ey
jo=oj
iwtxlo=olxtwi
sc=cs
cfcbcbcg=gcbcbcfc
kp=pk
wv=vw
t=t
zuvqjoygxh=hxgyojqvuz
us=su
ofqi=iqfo
gqsdbhhyn=nyhhbdsqg
ig=gi
beafgb=bgfaeb
ajtczc=czctja
gzn=nzg
mm=mm
lyh=hyl
frbfe=efbrf
vkblnej=jenlbkv
dbthkz=zkhtbd
zsz=zsz
zkdasbz=zbsadkz
mgghza=azhggm
jjfvngq=qgnvfjj
acio=oica
scr=rcs
odicjhfi=ifhjcido
y=y
arz=zra
v=v
icld=dlci
qa=aq
e=e
p=p
ccyhxy=yxhycc
vvp=pvv
gysdt=tdsyg
lezonpfco=ocfpnozel
qoinnbpxz=zxpbnnioq
gtmropz=zpormtg
hh=hh
kanclex=xelcnak
khxczw=wzcxhk
pqmfuybhni=inhbyufmqp
naunl=lnuan
ouiipucxjz=zjxcupiiuo
pop=pop
srviqqivo=oviqqivrs
i=i
xyrswissn=nssiwsryx
lcjpw=wpjcl
swgvzrntu=utnrzvgws
p=p
igsuskkua=aukksusgi
kzwuevviv=vivveuwzk
r=r
gvoh=hovg
xgdqood=dooqdgx
rtcxfa=afxctr
gaacwwnfk=kfnwwcaag
cqxyzkfv=vfkzyxqc
fqeaqr=rqaeqf
ljpzp=pzpjl
wkd=dkw
sjekoai=iaokejs
jkdqhnq=qnhqdkj
b=b
xr=rx
lbxwsm=mswxbl
hfquazp=pzauqfh
pyo=oyp
izyvnnbxaw=waxbnnvyzi
driecpgfl=lfgpceird
ucseh=hescu
wp=pw
ubr=rbu
gdoq=qodg
xuevt=tveux
abnxkt=tkxnba
veeo=oeev
ip=pi
zjkqh=hqkjz
honml=lmnoh
iobaswc=cwsaboi
kyiufhdbca=acbdhfuiyk
muy=yum
paqp=pqap
sdgjas=sajgds
fnitwgvj=jvgwtinf
vwvflr=rlfvwv
gozaejwid=diwjeazog
svwoorbuj=jubroowvs
bjlvjvby=ybvjvljb
fyu=uyf
kanmpse=espmnak
cebig=gibec
fdcajrghh=hhgrjacdf
ddw=wdd
kznvcu=ucvnzk
zpvd=dvpz
cnglgt=tglgnc
flqvpswxt=txwspvqlf
qhnunz=znunhq
upzurnuiz=ziunruzpu
qbfbpxraq=qarxpbfbq
ihfco=ocfhi
nuqgdwk=kwdgqun
fxtfy=yftxf
wos=sow
z=z
fepxyug=guyxpef
qwjuy=yujwq
du=ud
bezoyr=ryozeb
xf=fx
dyivds=sdviyd
